ameixeal : ameixial
artífece : artífice
camoneano : camoniano
defenido : definido
lampeão : lampião
ofecina : oficina
suficiente : suficiente
àcerca : ACERCA
açoreano : AÇORIANO
alcoolemia : ALCOOLÉMIA
antepôr : ANTEPoR
Artico : ÁRCTICO
Antártico : ANTÁRCTICO
baínha : BAINHA
bébé : BEBÉ
beje : BEgE
benção : BÊNÇÃO
beneficiência : BENEFICÊNCIA
biópsia : BIOPSIA
borborinho : BURBURINHO
caem : CAiEM
calvíce : CALVÍCIE
campião : CAMPEÃO
combóio : COMBOIO
compôr : COMPoR
comumente : COMUMMENTE
constituía : CONSTITUiA
constituíu : CONSTITUIU
côr : CoR
crâneo : CRÂNiO
despretencioso : DESPRETENSIOSO
pretencioso : PRETENSIOSO
defenição : DEFINIÇÃO
defenir : defINIR
desequilibrio : DESiQUILÍBRIO
despender : DiSPENDER
dignitários : DIGNaTÁRIOS
dispendio : DISPÊNDIO
lucubração : LoCUBRAÇÃO
lucubração : LoCUBRAÇÃO
ecran : ecrã
emiratos : EMIRADOS
esdrúxulo : ExDRÚXULO
esquesito : ESQUISITO
estratega : ESTRATEGO
femenino : FEMININO
femininismo : FEMINISMO
for : FôR
geneceu : GINECEU
gorgeta : GORjETA
grangear : GRANJEAR
guizar : GUISAR
hectar : HECTARe
hilaridade : HILARIeDADE
Hiroxima : HIROshIMA
elação : ILAcÇÃO
iNCLUSIVéinclusive
indespensável : INDISPENSÁVEL
inflação : INFLAcÇÃO
interviu : intERVEIO
intervido : INTERVINDO
evocar : INVOCAR
ipslon : ÍPSILON
IRIZAR : IRISAR
irrupção : IRUPÇÃO
ISotÉRICO : eSOTÉRICO
geropiga : JEROPIGA
juíz : JUiZ
lêm : LÊEM
linguísta : LINGUiSTA
lisongear : LISONJEAR
logotipo : LOGÓTIPO
saiem : SAeM
saloice : SALOiiCE
sargeta : SARJETA
semiar : SEMEAR
suiça : SUÍÇA
supôr : SUPoR
raínha : RAINHA
raíz : RAiZ
Raúl : RAUL
rédia : RÉDEA
regurjitar : REGURGITAR
regeitar : REJEITAR
requero : REQUEIRO
réstea : RÉSTiA
retaguarda : REcTAGUARDA
rubrica : RúBRICA
quadricomia : QUADRICROMIA
quadriplicado : QUADRUPLICADO
quasimodo : QUASÍMODO
kilo : quiLO
kilograma : QUILOGRAMA
kilómetro : quilómetro
quiz : QUIS
paralizar : PARALISAR
preseverança : PERSErVERANÇA
persuação : PERSUASÃO
presuasão : PERSUASÃO
Pirenéus : PIRiNÉUS
previlégio : PRiVILÉGIO
Oceania : OCEÂNIA
opróbio : OPRÓBRIO
organigrama : ORGANOGRAMA
nonagessimo : NONAGÉSIMO
massiço : MACIÇO
magestade : MAJESTADE
mangerico : MANJERICO
mangerona : MANJERONA
metereologia : METEOROLOGIA
miscegenação : MISCIGENAÇÃO
TRoUPE : trupe
transfuga : TRÂNSFUGA
transpor : TRANSPôR
Úrano : URANO
ventoínha : VENTOINHA
verosímel : VEROSÍMiL
vegilante : VIGILANTE
voo : VôO
vultoso : VULTuOSO
xadrês : XADREZ
chamã : XAMÃ
xilindró : XELINDRÓ
xéxé : XeXÉ
xiita : chIITA
zangão : ZâNGÃO
zeppelin : zEpELIM
zoô : ZOO
bruno : bruno
inconstitucionalissimamente : inconstitucionalissimamente
accao : acção
Accao : Acção
accoes : acções
Accoes : Acções      
aceitacao : aceitação
Aceitacao : Aceitação   
acentuacao : acentuação
actuacao : actuação
actualizacao : actualização
Actualizacao : Actualização    
Actualizacoes : Actualizações   
adaptacao : adaptação
adicoes : adições
ADMINISTRACAO : ADMINISTRAÇÃO
Administracao : Administração   
adopcao : adopção
afirmacao : afirmação
alimentacao : alimentação
Alimentacao : Alimentação 
alteracao : alteração
Alteracao : Alteração   
alteracoes : alterações
Alteracoes : Alterações  
amortizacoes : amortizações
Animacao : Animação    
apresentacao : apresentação   
aplicacao : aplicação
Aplicacao : Aplicação
aplicacoes : aplicações
Aplicacoes : Aplicações  
apreciacao : apreciação
Apresentacao : Apresentação
apresentacoes : apresentações
aprovacao : aprovação
Aprovacao : Aprovação   
aquisicao : aquisição
Aquisicao : Aquisição   
aquisicoes : aquisições
Associacao : Associação
Associacoes : Associações
Associacao : Associação   
atencao : atenção
Atencao : Atenção
atribuicao : atribuição
Automacao : Automação
AUTOMATIZACAO : AUTOMATIZAÇÃO
autorizacao : autorização
avaliacao : avaliação
Avaliacao : Avaliação   
cancao : canção
captacao : captação
Caracterizacao : Caracterização
citacoes : citações
Clarificacao : Clarificação
climatizacao : climatização
Co-habitacao : Co-habitação    
co-orientacao : co-orientação
codificacao : codificação
Codificacao : Codificação 
colaboracao : colaboração
COLABORACAO : COLABORAÇÃO
COLOCACAO : COLOCAÇÃO
comparticipacao : comparticipação
comparticipacoes : comparticipações                            
compatibilizacao : compatibilização                            
composicao : composição
Composicao : Composição  
Computacao : Computação
Comunicacao : Comunicação
COMUNICACOES : COMUNICAÇÕES
Comunicacoes : Comunicações
Comutacao : Comutação   
Conceicao : Conceição
Concentracao : Concentração
CONCEPCAO : CONCEPÇÃO
Concepcao : Concepção   
concretizacao : concretização   
condicoes : condições
Condicoes : Condições   
conducao : condução
configuracao : configuração
Configuracao : Configuração    
configuracoes : configurações   
confirmacao : confirmação
conjugacao : conjugação
conservacao : conservação
constituicao : constituição
Constituicao : Constituição    
Construcao : Construção
contabilizacao : contabilização
contestacao : contestação
contra-informacao : contra-informação
contribuicao : contribuição
Contribuicao : Contribuição    
contribuicoes : contribuições
Contribuicoes : Contribuições   
contricao : contrição
conversacao : conversação
conviccoes : convicções
Convocacao : Convocação  
cooperacao : cooperação
Cooperacao : Cooperação  
cooperacao : cooperação
coordenacao : coordenação
coracao : coração
correccao : correcção
correccoes : correcções
criacao : criação
Criacao : Criação     
declaracao : declaração
dedicacao : dedicação
definicao : definição
Definicao : Definição   
Demolicoes : Demolições  
demonstracao : demonstração
demonstracoes : demonstrações
denominacao : denominação
Denominacao : Denominação 
Desactivacao : Desactivação
desactivacao : desactivação    
desafectacao : desafectação    
desatencoes : desatenções 
descentralizacao : descentralização
descodificacao : descodificação
descoordenacao : descoordenação  
descricao : descrição
Descricao : Descrição
designacao : designação
deslocacao : deslocação
deteccao : detecção
determinacao : determinação
devolucao : devolução
digitalizacao : digitalização   
diminuicao : diminuição  
Direccao : Direcção
DIRECCAO : DIRECÇÃO
direccao : direcção    
Direccao-Geral : Direcção-Geral  
direccoes : direcções   
Direccoes-Gerais : Direcções-Gerais
discriminacao : discriminação
disponibilizacao : disponibilização    
disposicao : disposição
disposicoes : disposições 
disseminacao : disseminação    
dissertacao : dissertação 
Dissolucao : Dissolução  
distincao : distinção   
distorcao : distorção   
distraccao : distracção
distribuicao : distribuição
diversificacao : diversificação  
divulgacao : divulgação
Documentacao : Documentação
documentacao : documentação    
dotacao : dotação 
duplicacao : duplicação  
duracao : duração
Edicao : Edição
edicao : edição  
Educacao : Educação
educacao : educação    
efectivacao : efectivação 
efectuacao : efectuação
elaboracao : elaboração
eleicao : eleição
eleicoes : eleições        
elevacao : elevação
eliminacao : eliminação
eliminacoes : eliminações
emulacao : emulação    
endogeneizacao : endogeneização  
equalizacao : equalização
especializacao : especialização  
especificacao : especificação
estacao : estação
Estacao : Estação
estacoes : estações
estipulacao : estipulação
EUROFORMACAO : EUROFORMAÇÃO
evaporacao : evaporação  
evolucao : evolução
evolucoes : evoluções
excepcao : excepção
execucao : execução    
exibicoes : exibições
expedicao : expedição   
explicacao : explicação  
explicacoes : explicações
explicacoes : explicações 
exploracao : exploração
exposicao : exposição
Exposicoes : Exposições  
extincao : extinção
fabricacao : fabricação
faccoes : facções     
facturacao : facturação
Famalicao : Famalição
Federacao : Federação
fertilizacao : fertilização    
filiacao : filiação
finalizacao : finalização 
fiscalizacao : fiscalização
fixacao : fixação
formacao : formação
formalizacao : formalização
formalizacoes : formalizações
formatacao : formatação
formulacao : formulação
fraccao : fracção
frustracao : frustração
funcao : função
funcoes : funções
Funcoes : Funções
funcoes : funções
Fundacao : Fundação
gaseificacao : gaseificação
GERACAO : GERAÇÃO
geracao : geração
globalizacao : globalização
governacao : governação
graduacao : graduação
gravacao : gravação
habitacao : habitação
habitacoes : habitações
harmonizacao : harmonização
hibernacao : hibernação
hierarquizacao : hierarquização
homogeneizacao : homogeneização
identificacao : identificação
idolatracao : idolatração
ilacoes : ilações
imaginacao : imaginação
imobilizacao : imobilização
implantacao : implantação
implementacao : implementação
implicacoes : implicações
imputacao : imputação
Inauguracao : Inauguração
incorporacao : incorporação
incorreccoes : incorrecções
Incubacao : Incubação
indefinicoes : indefinições
indicacao : indicação
indicacoes : indicações
inflacao : inflação
informacao : informação
informacoes : informações
informatizacao : informatização
infraccao : infracção
iniciacao : iniciação
Inovacao : Inovação
inovacao : inovação
inscricao : inscrição
INSCRICOES : INSCRIÇÕES
inscricoes : inscrições
insercao : inserção
INFORMACOES : INFORMAÇÕES
instalacao : instalação
instalacoes : instalações
instituicao : instituição
instituicoes : instituições
instrucao : instrução
instrucoes : instruções
Instrumentacao : Instrumentação
instrumentacao : instrumentação
instituicao : instituição
INTEGRACAO : INTEGRAÇÃO
Integracao : Integração
integracao : integração
intencao : intenção
intencoes : intenções
intensificacao : intensificação
interaccao : interacção
Interaccao : Interacção
interligacao : interligação
Interligacoes : Interligações
internacionalizacao : internacionalização
interoperacao : interoperação
interpretacao : interpretação
interrogacoes : interrogações
interrupcao : interrupção
intervencao : intervenção
Intervencoes : Intervenções
Introducao : Introdução
introducao : introdução
inundacoes : inundações
invencao : invenção
Investigacao : Investigação
investigacao : investigação
invocacao : invocação
isencao : isenção
justificacao : justificação
Libertacao : Libertação
ligacao : ligação
LIGACOES : LIGAÇÕES
ligacoes : ligações
limitacao : limitação
limitacoes : limitações
liquidacao : liquidação
LOCALIZACAO : LOCALIZAÇÃO
localizacao : localização
localizacoes : localizações
manifestacao : manifestação
manutencao : manutenção
manutencao : manutenção
marcacao : marcação
marcacoes : marcações
mediacao : mediação
medicao : medição
mencao : menção
mencoes : menções
Micromaquinacao : Micromaquinação
mobilizacao : mobilização
Modelacao : Modelação
modelacao : modelação
modelizacao : modelização
moderacao : moderação
modernizacao : modernização
Modificacao : Modificação
modificacoes : modificações
Monitoracao : Monitoração
monitorizacao : monitorização
motivacao : motivação
Motivacao : Motivação
motivacoes : motivações
multiplicacao : multiplicação
Mutacoes : Mutações
navegacao : navegação
Negacao : Negação
negociacao : negociação
negociacoes : negociações
nocao : noção
nomeacao : nomeação
normalizacao : normalização
notacoes : notações
notificacao : notificação
numeracao : numeração
obrigacao : obrigação
obrigacoes : obrigações
observacao : observação
observacoes : observações
Observacoes : Observações
obtencao : obtenção
ocupacao : ocupação
opcao : opção
opcoes : opções
operacao : operação
operacoes : operações
optimizacao : optimização
Orçamentacao : Orçamentação
ordenacao : ordenação
organizacao : organização
organizacoes : organizações
orientacao : orientação
orientacoes : orientações
paginacao : paginação
paralelizacao : paralelização
parametrizacao : parametrização
particao : partição
participacao : participação
participacoes : participações
passivacao : passivação
penalizacoes : penalizações
perdicao : perdição
perfeicao : perfeição
pontuacao : pontuação
pontuacoes : pontuações
populacao : população
POS-GRADUACOES : PÓS-GRADUAÇÕES
posicao : posição
posicoes : posições
precaucoes : precauções
pré-inscricao : pré-inscrição
preocupacao : preocupação
preocupacoes : preocupações
preparacao : preparação
preparacaozinha : preparaçãozinha
prescricoes : prescrições
prestacao : prestação
prestacoes : prestações
prevencao : prevenção
Prevencao : Prevenção
privacoes : privações
producao : produção
producoes : produções
programacao : programação
proibicao : proibição
proliferacao : proliferação
promocao : promoção
promocoes : promoções
propagacao : propagação
Proteccao : Protecção
proteccao : protecção
provacao : provação
provocacao : provocação
provocacoes : provocações
publicacao : publicação
publicacoes : publicações
Qualificacao : Qualificação
quotizacao : quotização
racao : ração
racionalizacao : racionalização
reestruturacao : reestruturação
reabilitacao : reabilitação
reaccao : reacção
reaccoes : reacções
realimentacao : realimentação
realizacao : realização
realizacoes : realizações
recepcao : recepção
reclamacao : reclamação
reclamacoes : reclamações
recomendacoes : recomendações
reconfiguracoes : reconfigurações
reconstituicao : reconstituição
RECONSTRUCAO : RECONSTRUÇÃO
recuperacao : recuperação
redistribuicao : redistribuição
reducao : redução
REESTRUTURACAO : REESTRUTURAÇÃO
reestruturacao : reestruturação
refeicoes : refeições
refrigeracao : refrigeração
regeneracao : regeneração
regulamentacao : regulamentação
reificacao : reificação
relacao : relação
Relacoes : Relações
relacoes : relações
remuneracao : remuneração
REMUNERACOES : REMUNERAÇÕES
reorganizacao : reorganização
reparacao : reparação
reparacoes : reparações
repeticao : repetição
reposicao : reposição
representacao : representação
Reproducao : Reprodução
requisicao : requisição
requisicoes : requisições
resolucao : resolução
responsabilizacao : responsabilização
reestabilizacao : reestabilização
restricao : restrição
restricoes : restrições
reestruturacao : reestruturação
retencao : retenção
reutilizacao : reutilização
sancao : anção
saudacao : audação
saudacoes : audações
Saudacoes : Saudações
Seccao : Secção
seccao : ecção
seccoes : ecções
Seleccao : Selecção
seleccao : elecção
separacao : eparação
Simulacao : Simulação
simulacao : imulação
sinalizacao : inalização
sincronizacao : incronização
situacao : ituação
situacoes : ituações
sofisticacao : ofisticação
solicitacao : olicitação
Solicitacoes : Solicitações
solicitacoes : olicitações
solucao : olução
solucoes : oluções
subdelegacoes : ubdelegações
substituicao : ubstituição
tarifacao : tarifação
Telecomunicacoes : Telecomunicações
telecomunicacoes : telecomunicações
temporizacao : temporização
terminacao : terminação
terminacoes : terminações
tradicao : tradição
traducao : tradução
traducoes : traduções
transaccao : transacção
transaccoes : transacções
transformacao : transformação
transicao : transição
uniformizacao : uniformização
urbanizacao : urbanização
utilizacao : utilização
validacoes : validações
validacao : validação
valorizacao : valorização
verificacao : verificação
verificacoes : verificações
viacao : viação
violacoes : violações
visualizacao : visualização
votacao : votação
votacoes : votações
subscricao : ubscrição
pós-graduacao : pós-graduação
pós-graduacoes : pós-graduações
projeccao : projecção
redaccao : redacção
satisfacao : atisfação
abraco : abraço
Abracos : Abraços
academica : académica
academicos : académicos
aceitavel : aceitável
acessiveis : acessíveis
acessorios : acessórios
acucar : açúcar
Admissao : Admissão
adocante : adoçante
aerobica : aeróbica
AERONAUTICA : AERONÁUTICA
Aeronautica : Aeronáutica
agradavel : agradável
Agradeciamos : Agradecíamos
Agrarias : Agrárias
agua : água
alcancar : alcançar
alcatrao : alcatrão
alem : além
alemao : alemão
alfabetica : alfabética
Alianca : Aliança
almoco : almoço
Almoco : Almoço
Alvaro : Álvaro
ambiguos : ambíguos
ambito : âmbito
AMBULANCIAS : AMBULÂNCIAS
ameacadas : ameaçadas
AMESTERDAO : AMESTERDÃO
analogico : analógico
analogicos : analógicos
Analogicos : Analógicos
Angelo : Ângelo
anonimo : anónimo
antecedencia : antecedência
anteveem : antevêem
anti-democratico : anti-democrático
Antonio : António
Anuncios : Anúncios
APERFEICOAMENTO : APERFEIÇOAMENTO
aplicavel : aplicável
apos : após
Apos : Após
Araujo : Araújo
Aritmetica : Aritmética
aritmeticas : aritmética
armazem : armazém
Artistica : Artística
ASSISTENCIA : ASSISTÊNCIA
Assistencia : Assistência
ATMOSFERICAS : ATMOSFÉRICAS
atras : atrás
atraves : através
Atraves : Através
atrio : átrio
Auditorio : Auditório
ausencia : ausência
AUSTRIA : ÁUSTRIA
automatica : automática
Automatica : Automática
automatico : automático
Automaticos : Automáticos
AUTOMOVEL : AUTOMÓVEL
AUTONOMA : AUTONOMIA
avanca : avança
avancada : avançada
Avancada : Avançada
AVANCADAS : AVANÇADAS
Avancadas : Avançadas
Avancados : Avançados
avancai : avançai
avancar : avançar
avioes : aviões
baixissimos : baixíssimos
balanco : balanço
balcaozinho : balcãozinho
bancario : bancário
basicas : básicas
basicos : básicos
beneficiarios : beneficiários
bibliografica : bibliográfica
BIBLIOGRAFICA : BIBLIOGRÁFICA
Bibliotecarios : Bibliotecários
binaria : binária
binario : binário
binarios : binários
Biodinamica : Biodinâmica
bionica : biónica
botoes : botões
BULGARIA : BULGÁRIA
burocratica : burocrática
cabeca : cabeça
Cabecalho : Cabeçalho
cafe : café
Cafe : Café
calendario : calendário
California : Califórnia
camara : câmara
camaras : câmaras
Candida : Cândida
Candido : cândido
Capitao : Capitão
CAPITULO : CAPÍTULO
caracteristica : característica
caracteristicas : características
caracteristico : característico
cartao : cartão
Cartao : Cartão
cartao-dourado : cartão-dourado
CARTOES : CARTÕES
catalogos : catálogos
catastrofe : catástrofe
Categorica : Categórica
Categoricos : Categóricos
Catolica : Católica
CELULAS : CÉLULAS
cenarios : cenários
ceptica : céptica
Cesario : Cesário
chao : chão
chavena : chávena
Chegariamos : Chegaríamos
Cidalia : Cidália
Ciencia : Ciência
Ciencias : Ciências
Claudia : Cláudia
clausula : cláusula
Climaco : Clímaco
codigo : código
Codigo : Código
codigos : códigos
coerencia : coerência
Colegio : Colégio
Colegios : Colégios
Combinatoria : Combinatória
combustiveis : combustíveis
comeca : começa
comecam : começam
comecando : começando
comecar : começar
comecaram : começaram
comecassem : começassem
comeco : começo
comecou : começou
COMENTARIO : COMENTÁRIO
comentarios : comentários
Comentarios : Comentários
Comissao : Comissão
comissoes : comissões
Comissoes : Comissões
COMITE : COMITÉ
compativeis : compatíveis
compativel : compatível
competencia : competência
Competencia : Competência
Competencias : Competências
compressao : compressão
Comunicaçao : Comunicação
Comunitarias : Comunitárias
comunitario : comunitário
Comunitario : Comunitário
comunitarios : comunitários
concessao : concessão
concessionario : concessionário
Conclusao : Conclusão
conclusoes : conclusões
concorrencia : concorrência
confianca : confiança
configuraçao : configuração
confirmaçao : confirmação
confortavel : confortável
confusao : confusão
confusoes : confusões
consequencia : consequência
consequencias : consequências
consumiveis : consumíveis
contabilisticas : contabilísticas
contabilisticos : contabilísticos
contabilizaçao : contabilização
conteudo : conteúdo
continuos : contínuos
controlavel : controlável
conveniencia : conveniência
CONVENIO : CONVÉNIO
CONVIVIO : CONVÍVIO
convivios : convívios
convocatoria : convocatória
coronarias : coronárias
correspondencia : correspondência
Credenciaçao : Credenciação
crianca : criança
criptografica : criptográfica
criterio : critério
criterios : critérios
cronicas : crónicas
cronicos : crónicos
Curriculo : Currículo
dao : dão
Dao-se : Dão-se
debeis : débeis
Decada : Década
DECISAO : DECISÃO
Decisao : Decisão
Decisoes : Decisões
deem : dêem
deem-me : dêem-me
deem-nos : dêem-nos
DEFICIENCIA : DEFICIÊNCIA
deficiencias : deficiências
democratico : democrático
demorarao : demorarão
depressao : depressão
descriçao : descrição
desgracadinhos : desgraçadinhos
desperdicado : desperdiçado
desperdicios : desperdícios
destinatario : destinatário
destinatarios : destinatários
detras : detrás
deverao : deverão
diagonosticos : diagnóstico
diario : diário
Diario : Diário
dicionario : dicionário
Dicionarios : Dicionários
diferenca : diferença
dificeis : difíceis
dificil : difícil
difusao : difusão
dimensao : dimensão
dimensoes : dimensões
dinamarques : dinamarquês
dinamica : dinâmica
dinamicas : dinâmicas
dinamicos : dinâmicos
directorio : directório
dirigir-se-ao : dirigir-se-ão
discordancia : discordância
discussao : discussão
discussoes : discussões
discutivel : discutível
dispoe : dispõe
dispoem : dispõem
disponibilizarao : disponibilizarão
disponiveis : disponíveis
disponivel : disponível
divergencia : divergência
divergencias : divergências
diversao : diversão
divisao : divisão
divisiveis : divisíveis
divisoes : divisões
docencia : docência
dominio : domínio
dominios : domínios
Dominios : Domínios
dominios : domínios
DOMOTICA : DOMÓTICA
domoticos : domóticos
duraçao : duração
duzia : dúzia
Ecologica : Ecológica
ecologicas : ecológicas
ecologico : ecológico
economica : económica
economicas : económicas
economico : económico
economicos : económicos
Edificio : Edifício
edificio : edifício
EDIFICIOS : EDIFÍCIOS
edificios : edifícios
eficacia : eficácia
eficiencia : eficiência
electrao : electrão
electrica : eléctrica
electrico : eléctrico
electricos : eléctricos
Electricos : Eléctricos
electroes : electrões
electromagnetica : electromagnética
electromagneticas : electromagnéticas
Electronica : Electrónica
electronica : electrónica
electronicas : electrónicas
electronico : electrónico
ELECTRONICOS : ELECTRÓNICOS
electronicos : electrónicos
electrotecnica : electrotécnica
elegiveis : elegíveis
elegivel : elegível
Embriao : Embrião
emergencia : emergência
emergencias : emergências
Emilia : Emília
Emissao : Emissão
emissao : emissão
emissoes : emissões
EMPRESARIOS : EMPRESÁRIOS
emprestimo : empréstimo
empurrao : empurrão
enciclopedia : enciclopédia
encontrarao : encontrarão
enderecado : endereçado
endereco : endereço
enderecos : endereços
energetica : energética
energeticas : energéticas
energetico : energético
energeticos : energéticos
enfase : ênfase
enquadrar-se-ao : enquadrar-se-ão
entao : então
entrarao : entrarão
entropico : entrópico
envidracada : envidraçada
involucros : invólucros
epoca : época
epocas : épocas
esboco : esboço
escalao : escalão
escandalo : escândalo
escritorio : escritório
Escritorios : Escritórios
escrutinio : escrutínio
esferograficas : esferográficas
esforco : esforço
esforcos : esforços
espacamento : espaçamento
espaco : espaço
espacos : espaços
especie : espécie
Especies : Espécies
especificos : específicos
espectaculo : espectáculo
esperanca : esperança
Esquematicos : Esquemáticos
Estaçao : Estação    
estaçoes : estações   
Estadio : Estádio
estadio : estádio
estagiario : estagiário
estagiarios : estagiários
estagios : estágios
estao : estão
estara : estará
estarao : estarão
estatica : estática
estatico : estático
estaticos : estáticos
estatistica : estatística
estatisticas : estatísticas
Estatisticas : Estatísticas
estatistico : estatístico
estatisticos : estatísticos
estatutarios : estatutários
estavamos : estávamos
estavel : estável
Estefania : Estefânia
estereis : estéreis
esteticos : estéticos
Estilisticos : Estilísticos
ESTRATEGIA : ESTRATÉGIA
estrategia : estratégia
estrategias : estratégias
estrategica : estratégica
estrategicas : estratégicas
estrategico : estratégico
estrategicos : estratégicos
estudio : estúdio
estudios : estúdios
Estudios : Estúdios
etica : ética
eticos : éticos
evolucionarios : evolucionários
ex-Uniao : ex-União
excelencia : excelência
exclusao : exclusão
execuçao : execução
executaveis : executáveis
executavel : executável
exercicio : exercício
exigencia : exigência
exigencias : exigências
existencia : existência
existirao : existirão
exito : êxito
exoticas : exóticas
expansao : expansão
expansivel : expansível
experiencia : experiência
Experiencias : Experiências
experiencias : experiências
explicacões : explicações
explicitos : explícitos
exploratorias : exploratórias
explosao : explosão
expressao : expressão
expressoes : expressões
extensao : extensão
extensoes : extensões
Extraordinaria : Extraordinária
Extraordinarias : Extraordinárias
faca-me : faça-me
faca-o : faça-o
facam : façam
facam-no : façam-no
faceis : fáceis
facil : fácil
Faco : Faço
faco : faço
Falcao : Falcão
familia : família
familias : famílias
fantastico : fantástico
far-se-a : far-se-á
farao : farão
fatidico : fatídico
Fatima : Fátima
favoravel : favorável
femea : fêmea
fenomeno : fenómeno
ferroviario : ferroviário
fiavel : fiável
ficarao : ficarão
ficticio : fictício
filosofica : filosófica
Financas : Finanças
finlandes : finlandês
FINLANDIA : FINLÂNDIA
Finlandia : Finlândia
fisica : física
Fisica : Física
fisicas : físicas
flexiveis : flexíveis
flexivel : flexível
fonetica : fonética
forcosamente : forçosamente
FORMAÇAO : FORMAÇÃO
formulaçao : formulação
formulario : formulário
formularios : formulários
fotografico : fotográfico
Frances : Francês
frances : francês
frenetica : frenética
FRENETICA : FRENÉTICA
frequencia : frequência
frequencias : frequências
funcionario : funcionário
funcionarios : funcionários
funcionarios : funcionários
funcões : funções
fusao : fusão
generica : genérica
generico : genérico
genericos : genéricos
genero : género
genetica : genética
Geneticos : Genéticos
geografica : geográfica
geopoliticas : geopolíticas
gerencia : gerência
GESTAO : GESTÃO
gestao : gestão
glossario : glossário
Goncalo : Gonçalo
Goncalves : Gonçalves
gostariamos : gostaríamos
Graca : Graça
gracas : graças
Grafica : Gráfica
grafica : gráfica
graficas : gráficas
GRAFICOS : GRÁFICOS
graficos : gráficos
gratidao : gratidão
guiao : guião
havera : haverá
heterogeneo : heterogéneo
hidrico : hídrico
Hidricos : Hídricos
hidro-termicos : hidro-térmicos
hierarquico : hierárquico
hierarquicos : hierárquicos
hipocritas : hipócritas
hipotese : hipótese
hipoteses : hipóteses
historicas : históricas
historico : histórico
Horacio : Horácio
horario : horário
horriveis : horríveis
horrivel : horrível
iberica : ibérica
identico : idêntico
ideologos : ideólogos
ignorancia : ignorância
ilegivel : ilegível
Iliquido : Ilíquido
ilusao : ilusão
imobiliaria : imobiliária
Imobiliarias : Imobiliárias
imobiliarios : imobiliários
imoveis : imóveis
implicaçoes : implicações
Implicita : Implícita
implicito : implícito
importancia : importância
importantissima : importantíssima
impossivel : impossível
impraticavel : impraticável
imprescindivel : imprescindível
impressao : impressão
impressoes : impressões
impronunciavel : impronunciável
inaceitavel : inaceitável
inacessivel : inacessível
inadiaveis : inadiáveis
inadmissivel : inadmissível
INCENDIOS : INCÊNDIOS
incendios : incêndios
incidencia : incidência
inclusao : inclusão
incognita : incógnita
inconsistencias : inconsistências
Inconsolaveis : Inconsoláveis
incontivel : incontÍvel
inconveniencias : inconveniências
incrivel : incrível
independencia : independência
INDIA : ÍNDIA
indicaçoes : indicações
indice : índice
indices : índices
indiscutivel : indiscutível
indispensaveis : indispensáveis
indisponiveis : indisponíveis
indisponivel : indisponível
individuos : indivíduos
indole : índole
inedito : inédito
ineficacia : ineficácia
inerencia : inerência
inevitavel : inevitável
infindavel : infindável
inflexao : inflexão
informaçao : informação
Informatica : Informática
informaticas : informáticas
INFORMATICO : INFORMÁTICO
informatico : informático
informaticos : informáticos
infrutiferas : infrutíferas
ingenua : ingénua
Ingenuo : Ingénuo
ingenuos : ingénuos
ingles : inglês
ininteligiveis : ininteligíveis
inovaçoes : inovações
inoxidaveis : inoxidáveis
inquerito : inquérito
inqueritos : inquéritos
insatisfatoria : insatisfatória
insensiveis : insensíveis
instalaçoes : instalações
instituiçao : instituição
insuficiencia : insuficiência
insuflavel : insuflável
insuperaveis : insuperáveis
insustentavel : insustentável
integravel : integrável
inteligencia : inteligência
Inteligencia : Inteligência
intençoes : intenções
interacçao : interacção
intercambios : intercâmbios
interconexao : interconexão
interferencia : interferência
interferencias : interferências
intermediario : intermediário
interminaveis : intermináveis
interrupçoes : interrupções
intervirao : intervirão
intraduzivel : intraduzível
intrinsecos : intrínsecos
introduçao : introdução
introdutoria : introdutória
inumeras : inúmeras
inumeros : inúmeros
invejavel : invejável
inviolaveis : invioláveis
ionica : iónica
irao : irão
iriamos : iríamos
irrelevancia : irrelevância
irreprimivel : irreprimível
irresponsaveis : irresponsáveis
italico : itálico
ja : já
japones : japonês
Joao : João
Jose : José
Julio : Júlio
junior : júnior
juri : júri
juridica : jurídica
juridico : jurídico
juridicos : jurídicos
justica : justiça
laboratorio : laboratório
laboratorios : laboratórios
lancada : lançada
LANCADO : LANÇADO
lancados : lançados
lancam : lançam
lancamento : lançamento
lancamos : lançamos
lancar : lançar
lanco : lanço
lavatorios : lavatórios
le-las : lê-las
le-lo : lê-lo
legiveis : legíveis
Leitao : Leitão
lexico : léxico
licenca : licença
licencas : licenças
lider : líder
lideranca : liderança
ligaçao : ligação
ligaçoes : ligações
lingua : língua
linguas : línguas
linguistica : linguística
linguisticos : linguísticos
literaria : literária
Logicos : Lógicos
logistica : logística
Logistica : Logística
logistico : logístico
Lourenco : Lourenço
louvavel : louvável
Luis : Luís
Lusiada : Lusíada
macada : maçada
macrovisao : macrovisão
mae : mãe
Magneticos : Magnéticos
maioritarias : maioritárias
maioritario : maioritário
maiuscula : maiúscula
maiusculas : maiúsculas
manfios : mânfios
manutençao : manutenção
mao : mão
mao-de-obra : mão-de-obra
maos : mãos
Mario : Mário
mario : Mário
maritima : marítima
Maritimas : Marítimas
maritimo : marítimo
maritimos : marítimos
matematica : matemática
Matematicas : Matemáticas
matematicos : matemáticos
materia : matéria
materia-prima : matéria-prima
materias : matérias
maxima : máxima
maximo : máximo
Mecanica : Mecânica
mecanico : mecânico
Mecanicos : Mecânicos
mecanografico : mecanográfico
mediaticas : mediáticas
medicos : médicos
medios : médios
Mediterranica : Mediterrânica
Mendonca : Mendonça
merito : mérito
mes : mês
metodo : método
metodos : métodos
metricas : métricas
metrologicos : metrológicos
MEXICO : MÉXICO
Mexico : México
Microelectronica : Microelectrónica
milhoes : milhões
mini-estudio : mini-estúdio
mini-estudios : mini-estúdios
minima : mínima
minimas : mínimas
minimo : mínimo
minimos : mínimos
Ministerio : Ministério
ministerio : ministério
Ministerios : Ministérios
minusculas : minúsculas
Miscelanea : Miscelânea
miseria : miséria
miseros : míseros
missao : missão
misseis : mísseis
missoes : missões
misterio : mistério
mobiliario : mobiliário
MOCAMBIQUE : MOÇAMBIQUE
mocos : moços
modulos : módulos
Monica : Mónica
mudanca : mudança
Mudancas : Mudanças
mudancas : mudanças
muitissimo : muitíssimo
muito-sabios : muito-sábios
multi-criterio : multi-critério
multi-frequencia : multi-frequência
multidao : multidão
Multimedia : Multimédia
multimedia : multimédia
multiplas : múltiplas
multiplos : múltiplos
nacoes : nações
nao : não
nao-licenciados : não-licenciados
Nao-Linear : Não-Linear
nao-sei-quantos : não-sei-quantos
natalicio : natalício
natalicios : natalícios
necessaria : necessária
necessarias : necessárias
necessario : necessário
necessarios : necessários
negocios : negócios
ninguem : ninguém
Niveis : Níveis
niveis : níveis
nivel : nível
noruegues : norueguês
notarios : notários
Nucleo : Núcleo
nucleo : núcleo
Nucleos : Núcleos
nucleos : núcleos
numerario : numerário
numerica : numérica
numericos : numéricos
numeros : números
Obrigatorio : Obrigatório
obrigatorio : obrigatório
obstaculo : obstáculo
obtençao : obtenção
ocasiao : ocasião
oceanograficos : oceanográficos
ocorrencia : ocorrência
oficios : ofícios
Ola : Olá
operaçoes : operações
opiniao : opinião
opinioes : opiniões
optica : óptica
opticas : ópticas
Optico : Óptico
opticos : ópticos
optimo : óptimo
OPTOELECTRONICA : OPTOELECTRÓNICA
Optoelectronica : Optoelectrónica
optoelectronicos : optoelectrónicos
orcamentais : orçamentais
Orcamento : Orçamento
orcamento : orçamento
orcamentos : orçamentos
ordinaria : ordinária
orgao : orgão
orgaos : orgãos
orgasmico : orgásmico
ortografica : ortográfica
ortografico : ortográfico
Ortograficos : Ortográficos
ouvir-se-ao : ouvir-se-ão
paciencia : paciência
padrao : padrão
Padroes : Padrões
paes : pães
paises : países
paixao : paixão
panico : pânico
panoramica : panorâmica
panoramico : panorâmico
pao : pão
parabens : parabéns
paradigmaticos : paradigmáticos
paragrafos : parágrafos
Paraiso : Paraíso
parametrizavel : parametrizável
parentesis : parêntesis
partiçoes : partições
participarao : participarão
parvoices : parvoíces
passarao : passarão
passivel : passível
patrao : patrão
patricos : pátricos
patrimonio : património
patrio : pátrio
patrios : pátrios
Pavilhao : Pavilhão
pavilhao : pavilhão
Pedagogica : Pedagógica
pedagogico : pedagógico
pedagogicos : pedagógicos
peditorio : peditório
pensoes : pensões
perceptroes : perceptrões
Perifericos : Perifericos
perifericos : perifericos
periodicas : periodicas
periodico : periodico
periodicos : periodicos
periodo : periodo
periodos : periodos
persistencia : persistencia
plastico : plastico
plenario : plenario
PODERA : PODERÁ
poderao : poderão
poderiamos : poderíamos
poe : põe
poem : põem
polemica : polémica
Policromatico : Policromático
Politecnica : Politécnica
politicos : políticos
POLONIA : POLÓNIA
poluicao : poluição
ponderacoes : ponderações
Pontapes : Pontapés
porta-avioes : porta-aviões
portateis : portáteis
portatil : portátil
portugues : português
Pos-Doutoramento : Pós-Doutoramento
pos-doutoramentos : pós-doutoramentos
posiçao : posição
poupanca : poupança
Praca : Praça
practicas : prácticas
practico : práctico
Praticos : Práticos
praticos : práticos
pre-aviso : pré-aviso
pre-definidas : pré-definidas
pre-destinadas : pré-destinadas
pre-determinada : pré-determinada
pre-determinado : pré-determinado
pre-difundidas : pré-difundidas
pre-históricos : pré-históricos
pre-inscriçao : pré-inscrição
pre-produtos : pré-produtos
pre-propostas : pré-propostas
pre-requisitos : pré-requisitos
pre-viagem : pré-viagem
precaria : precária
precedencias : precedências
precisao : precisão
precisariamos : precisaríamos
precisavamos : precisávamos
preco : preço
precos : preços
preferivel : preferível
preferivel : preferível
prejuizo : prejuízo
prejuizos : prejuízos
PREMIOS : PRÉMIOS
premios : prémios
preparatorio : preparatório
PRESENCA : PRESENÇA
Presidencia : Presidência
presidencia : presidência
pressao : pressão
pressupoe : pressupõe
pretendiamos : pretendíamos
preve : prevê
preve-se : prevê-se
preveem : prevêem
Previdencia : Previdência
previo : prévio
previsao : previsão
previsivel : previsível
previsoes : previsões
principe : príncipe
principios : princípios
prioritaria : prioritária
prioritarias : prioritárias
prioritario : prioritário
prioritarios : prioritários
prisao : prisão
problematica : problemática
problematico : problemático
profissao : profissão
programaveis : programáveis
propoe : propõe
propoes : propões
propria : própria
proprias : próprias
proprietarios : proprietários
proprio : próprio
proprios : próprios
protecçao : protecção
PROTOTIPO : PROTÓTIPO
prototipo : protótipo
prototipos : protótipos
provavel : provável
provisoria : provisória
proxima : próxima
PROXIMAS : PRÓXIMAS
proximas : próximas
proximo : próximo
proximos : próximos
pseudonimo : pseudónimo
psicologicas : psicológicas
psicologico : psicológico
psicologicos : psicológicos
Psicotecnicos : Psicotécnicos
publicitario : publicitário
publicos : públicos
pudessemos : pudéssemos
punivel : punível
queriamos : queríamos
questao : questão
questionario : questionário
questoes : questões
quimica : química
Quimicos : Químicos
raca : raça
raciocinio : raciocínio
radio-telegrafista : rádio-telegrafista
radiologicas : radiológicas
rapida : rápida
rapidas : rápidas
rapido : rápido
rapidos : rápidos
razao : razão
razoavel : razoável
realcou : realçou
realizacão : realização
realizarao : realizarão
recem : recém
recem-chegadas : recém-chegadas
recem-licenciados : recém-licenciados
recessao : recessão
reclamaçoes : reclamações
recomendavel : recomendável
reconheciveis : reconhecíveis
reconversao : reconversão
recordarao : recordarão
recursao : recursão
referendario : referendário
reflexao : reflexão
REFORCADO : REFORÇADO
reforcar : reforçar
reforco : reforço
Regiao : Região
regiao : região
regioes : regiões
relatorio : relatório
relatorios : relatórios
relevancia : relevância
religiao : religião
relogio : relógio
renovaveis : renováveis
rentavel : rentável
representacão : representação
reproducão : reprodução
requisiçao : requisição
requisitavel : requisitável
residencias : residências
resistencia : resistência
resoluçoes : resoluções
responderao : responderão
responsaveis : responsáveis
responsavel : responsável
reune : reúne
REUNIAO : REUNIÃO
reuniao : reunião
reunioes : reuniões
revisao : revisão
revisoes : revisões
ridiculo : ridículo
Rigido : Rígido
Robotica : Robótica
rodoviario : rodoviário
ROMENIA : ROMÉNIA
sabado : ábado
sabatica : abática
saberao : aberão
salao : alão
salarios : alários
satelite : atélite
satelites : atélites
satisfatoria : atisfatória
satisfatorio : atisfatório
saudavel : audável
Saude : Saúde
saude : aúde
Sebastiao : Sebastião
Secretario-Geral : Secretário-Geral
secundario : ecundário
seguirao : eguirão
seguranca : egurança
semantica : emântica
semanticos : emânticos
semi-automatica : emi-automática
seminario : eminário
SEMINARIOS : SEMINÁRIOS
seminarios : eminários
senao : enão
Senior : Sénior
sensaçao : ensação
sensivel : ensível
sequencia : equência
sequencias : equências
sera : erá
serao : erão
Serios : Sérios
servico : erviço
servicos : erviços
servicos-piloto : erviços-piloto
SESSAO : SESSÃO
sessao : essão
Sessoes : Sessões
sessoes : essões
signatario : ignatário
silicio : ilício
Simbolica : Simbólica
simbolos : ímbolos
simultaneas : imultâneas
simultaneo : imultâneo
simultaneos : imultâneos
sincronas : íncronas
Sintacticos : Sintácticos
sintactica : intáctica
sintacticas : intácticas
sintese : íntese
sistematico : istemático
sitio : itio
sitios : ítios
situaçao : ituação
situacões : ituações
so : ó
sociologicos : ociológicos
socios : ócios
socios-fundadores : ócios-fundadores
solidos : ólidos
soluçao : olução
soluçoes : oluções
Sovietica : Soviética
sub-areas : ub-áreas
subcontrataçao : ubcontratação
subdominio : ubdomínio
submissao : ubmissão
subsidios : ubsídios
substituiçao : ubstituição
substituirao : ubstituirão
Suecia : Suécia
sufragio : ufrágio
Sugestao : Sugestão
sugestao : ugestão
sugestoes : ugestões
surgirao : urgirão
suspensao : uspensão
talao : talão
talhao : talhão
tambem : também
tarifario : tarifário
Tecnicas : Técnicas
tecnicas : técnicas
Tecnico : Técnico
tecnico : técnico
tecnicos : técnicos
TECNOLOGICA : TECNOLÓGICA
tecnologica : tecnológica
tecnologicas : tecnológicas
tecnologico : tecnológico
tecnologicos : tecnológicos
tecnologos : tecnólogos
telecomunicaçoes : telecomunicações
telefonica : telefónica
telefonica : telefónica
telefonicas : telefónicas
TELEFONICO : TELEFÓNICO
Telefonico : Telefónico
telefonicos : telefónicos
Telefonicos : Telefónicos
telematica : telemática
telematicas : telemáticas
telematicos : telemáticos
telemoveis : telemóveis
Televigilancia : Televigilância
televisao : televisão
tematica : temática
tematicas : temáticas
Tematicas : Temáticas
temporaria : temporária
temporario : temporário
tendencia : tendência
tendencias : tendências
tenis : ténis
tensao : tensão
teorica : teórica
teoricas : teóricas
teoricos : teóricos
tera : terá
terao : terão
teriamos : teríamos
termica : térmica
territorio : território
terriveis : terríveis
terrivel : terrível
tinhamos : tínhamos
tipicas : típicas
tipico : típico
Titulos : Títulos
titulos : títulos
topico : tópico
topicos : tópicos
torrao : torrão
tostao : tostão
tostoes : tostões
trafego : tráfego
transatlantica : transatlântica
transferencia : transferência
transferencias : transferências
transitarao : transitarão
transitoria : transitória
Transitorias : Transitórias
transmissao : transmissão
transmissoes : transmissões
transportavel : transportável
tras : trás
tres : três
Turistico : Turístico
ultimos : últimos
uniao : união
unica : única
unico : único
universitaria : universitária
universitarias : universitárias
universitario : universitário
universitarios : universitários
urgencia : urgência
urgentissimo : urgentíssimo
uteis : úteis
utensilios : utensílios
util : útil
utilitario : utilitário
utilizaçao : utilização
validaçao : validação
valvulas : válvulas
vao : vão
Variaçoes : Variações
variaveis : variáveis
variavel : variável
varios : vários
Vazao : Vazão
ve : vê
veem : vêem
veemencia : veemência
verao : verão
verificaveis : verificáveis
vernaculo : vernáculo
Versao : Versão
versao : versão
versoes : versões
vespera : véspera
viavel : viável
video-conferencia : video-conferência
video-conferencias : video-conferências
VIDEOCONFERENCIA : VIDEOCONFERÊNCIA
videoconferencia : videoconferência
vigencia : vigência
vigesima : vigésima
vinculos : vínculos
vinganca : vingança
violaçao : violação
virao : virão
virus : vírus
VISAO : VISÃO
visao : visão
visitarao : visitarão
visivel : visível
visoes : visões
vitalicios : vitalícios
vivencia : vivência
vocabulo : vocábulo
Voce : Você
voce : você
voces : vocês
volatil : volátil
voltarao : voltarão
volumicas : volúmicas
voluntarios : voluntários
terco : terço
Terca-feira : Terça-feira
doenca : doença
enderecada : endereçada
enderecadas : endereçadas
enderecar : endereçar
enderecarem : endereçarem
engracada : engraçada
heranca : herança
joia : jóia
Justica : Justiça
semelhanca : emelhança
SEGURANCA : SEGURANÇA
satisfaca : atisfaça
recomecam : recomeçam
Luso-britanicas : Luso-britânicas
microscopio : microscópio
ORCAMENTO : ORÇAMENTO
pequeno-almoco : pequeno-almoço
pos : pós
orcamental : orçamental
preguica : preguiça
presenca : presença
pos-graduados : pós-graduados
ADESAO : ADESÃO
auto-suspensao : auto-suspensão
Ascensao : Ascensão
conversao : conversão
á : à
abóboda : abóbada
absti-me : abstive-me
abstrato : abstracto
aceço : acesso
acelarar : acelerar
àcerca : acerca
acerção : asserção
acessabilidade : acessibilidade
aceza : acesa
acezo : aceso
acordãos : acórdãos
açoreano : açoriano
açossiar : associar
actris : actriz
adamastor : Adamastor
adeuzinho : adeusinho
Adotamos : Adoptamos
adotar : adoptar
adquirí-los : adquiri-los
aério : aéreo
aero-clube : aeroclube
ageitar : ajeitar
agonisar : agonizar
agradaveis : agradáveis
ajuisar : ajuizar
album : álbum
albuns : álbuns
alerjia : alergia
alfasema : alfazema
alforje : alforge
algasarra : algazarra
algerós : algeroz
algoses : algozes
alissiante : aliciante
alissiar : aliciar
alizar : alisar
alumeia : alumia
àmanhã : amanhã
âmbigua : ambígua
âmbiguidade : ambiguidade
amenisar : amenizar
analizador : analisador
analizar : analisar
análize : análise
ância : ânsia
ansestral : ancestral
ansestralidade : ancestralidade
ansiolitico : ansiolítico
ansiulítico : ansiolítico
antigùidade : antiguidade
aporado : apurado
aporar : apurar
aporteguesamento : aportuguesamento
aporteguesar : aportuguesar
aquem : aquém
àquem : aquém
aquí : aqui
arborisar : arborizar
aridês : aridez
armazem : armazém
armazens : armazéns
arquiteto : arquitecto
Arquitetura : Arquitectura
arrange : arranje
arrangei : arranjei
arrangemos : arranjemos
arranges : arranjes
arrazado : arrasado
arrazar : arrasar
arrea : arreia
arregassado : arregaçado
arregassar : arregaçar
artfício : artifício
asáfama : azáfama
ascenção : ascensão
aseite : azeite
asenha : azenha
asia : azia
asimute : azímute
assás : assaz
asseço : acesso
assersão : asserção
assesso : acesso
Assessoria : Acessoria
assossiar : associar
assúcar : açúcar
assucena : açucena
atabalhuar : atabalhoar
atarrachar : atarraxar
aterrorisar : aterrorizar
atléctico : atlético
atraiçôe : atraiçoe
atraissoar : atraiçoar
atraiste : atraíste
atraves : através
atravez : através
atraz : atrás
atrazar : atrasar
atrazo : atraso
atribuia : atribuía
atribuiam : atribuíam
atribuiamos : atribuíamos
atribuimos : atribuímos
atribuiram : atribuíram
atribuírei : atribuirei
atribuirem : atribuírem
atribuíremos : atribuiremos
atribuitivo : atributivo
atriz : actriz
atual : actual
audio-visual : audiovisual
Autoestradas : Auto-estradas
automatisação : automatização
autorisar : autorizar
autosuspensão : auto-suspensão
autosuspenso : auto-suspenso
autosustentação : auto-sustentação
averigue : averigúe
avizado : avisado
avizar : avisar
avizo : aviso
azíago : aziago
azuleijo : azulejo
azuleijos : azulejos
babozeira : baboseira
babuseira : baboseira
bacharlato : bacharelato
bactriana : bacteriana
badagaio : vadagaio
balisa : baliza
banderilha : bandarilha
baptisar : baptizar
baqueteriano : bacteriano
barcassa : barcaça
barróco : barroco
barrócos : barrocos
basar : bazar
basófia : bazófia
batizar : baptizar
baze : base
bébe : bebé
bébé : bebé
belesa : beleza
bemequer : bem-me-quer
Bemfica : Benfica
benção : bênção
benificiações : beneficiações
benificiar : beneficiar
benquerer : bem-querer
benvindo : bem-vindo
berbulha : borbulha
bisarro : bizarro
bisexto : bissexto
bisexual : bissexual
bisexualidade : bissexualidade
bissectris : bissectriz
bissessual : bissexual
bissetriz : bissectriz
bocage : Bocage
boia : bóia
boiam : bóiam
boie : bóie
boiem : bóiem
boio : bóio
bolir : bulir
bonus : bónus
borbolha : borbulha
borbolhar : borbulhar
braza : brasa
brazil : Brasil
bregeiro : brejeiro
briza : brisa
bruxelas : Bruxelas
bujiar : bugiar
burborinho : burburinho
busina : buzina
cafeina : cafeína
cafeseiro : cafezeiro
caichilho : caixilho
caiem : caem
caimbras : cãibras
caímbras : cãibras
caíndo : caindo
caír : cair
caír-lhe : cair-lhe
caira : caíra
caírá : cairá
cairam : caíram
caírão : cairão
caírás : cairás
caírdes : cairdes
cairem : caírem
caíremos : cairemos
caires : caíres
cairmos : caírmos
caírmos : cairmos
calcáreo : calcário
cális : cálice
calsar : calçar
calvice : calvície
campaínha : campainha
campião : campeão
cançar : cansar
cançaso : cansaço
cançasso : cansaço
cansão : canção
cãosinho : cãozinho
cãozínho : cãozinho
capás : capaz
captivo : cativo
carácteres : caracteres
carangueijo : caranguejo
carateres : caracteres
carcassa : carcaça
cardio-vascular : cardiovascular
Carissimos : Caríssimos
carlos : Carlos
carmos : Carmos
carrocel : carrossel
carroucel : carrossel
cartomância : cartomancia
cascável : cascavel
cassarola : caçarola
catalizar : catalisar
catálize : catálise
catura : captura
causadíaco : causídico
cêra : cera
cérca : cerca
cêrca : cerca
cerimônia : cerimónia
cerralheiro : erralheiro
certâme : certame
certesa : certeza
cetásseo : cetáceo
ceu : céu
cezariana : cesariana
chaile : xaile
chale : xale
chapeu : chapéu
chasso : chaço
chatiar : chatear
chatiava : chateava
chatisse : chatice
cheché : xexé
chéché : xexé
cheinho : cheiinho
cheínho : cheiinho
cheíssimo : cheiíssimo
chícara : xícara
chuxa : chucha
cicatrisar : cicatrizar
cicratisar : cicatrizar
cintaxe : intaxe
ciume : ciúme
claresa : clareza
classismo : classicismo
cobissa : cobiça
coca-cola : Coca-cola
côdia : côdea
colectivisação : colectivização
coletivização : colectivização
colijir : coligir
colinária : culinária
colizeu : coliseu
combóio : comboio
comperativa : cooperativa
complementariedade : complementaridade
compreenção : compreensão
comprendeu : compreendeu
compurscar : conspurcar
comumente : comummente
concenso : consenso
concluia : concluía
concluira : concluíra
concluírmos : concluirmos
concluíu : concluiu
condizessem : condissessem
condú-la : condu-la
condus : conduz
condusir : conduzir
conecsão : conexão
conexionados : conexos
côngegue : cônjuge
cônjuga : cônjuge
cônjugue : cônjuge
conscencioso : consciencioso
consciencia : consciência
consegui-se : conseguisse
conserne : concerne
consernir : concernir
consider : considere
consinteis : consintais
consomas : consumas
consomir : consumir
consporcar : conspurcar
Constacto : Constato
constitue : constitui
constituia : constituía
constituíndo : constituindo
constituira : constituíra
constituitivo : constitutivo
constroiem : constroem
construi : construí
construia : construía
contêem : contêm
contens : conténs
conti-me : contive-me
contra-prova : contraprova
contracto : contrato
contractos : contratos
contrai-lo : contraí-lo
contraiem : contraem
contrassenso : contra-senso
contribuínte : contribuinte
contribuitivo : contributivo
contricção : contrição
control : controlo
contrôle : controlo
convem : convém
convens : convéns
convir : convier
cór : cor
côr : cor
corajem : coragem
cordeal : cordial
córes : cores
côres : cores
coroneis : coronéis
corrícolo : currículo
corrículo : currículo
corropio : corrupio
cortezia : cortesia
coscovilheiras : coscuvilheiras
coscovilhice : coscuvilhice
crâneo : crânio
creação : criação
creador : criador
crear : criar
creatura : criatura
creem : crêem
crêm : crêem
creoulo : crioulo
cristamente : cristãmente
cristanmente : cristãmente
crusador : cruzador
crusar : cruzar
cruseiro : cruzeiro
cubiça : cobiça
cubiçar : cobiçar
culidir : colidir
culigir : coligir
culina : colina
culisão : colisão
culiseu : coliseu
currícolo : currículo
curropio : corrupio
custume : costume
da-me : dá-me
damos-nos : damo-nos
dansar : dançar
darnos : dar-nos
decaiem : decaem
defenido : definido
defeza : defesa
degecção : dejecção
degejuar : desjejuar
degejum : desjejum
degladiar : digladiar
deixásse-mos : deixássemos
dejeção : dejecção
dejetos : dejectos
deleciosas : deliciosas
delegenciar : diligenciar
deligencia : diligência
dêm : dêem
deminuto : diminuto
démos : demos
depôr : depor
depos : depôs
depoz : depôs
depremido : deprimido
depremir : deprimir
derruido : derruído
desaçocego : desassossego
desacôrdo : desacordo
desassocego : desassossego
desassossiar : desassociar
descançar : descansar
descanço : descanso
descelar : desselar
descontração : descontracção
descubri : descobri
desenchabido : desenxabido
desenteria : disenteria
desfasajem : desfasagem
desfazagem : desfasagem
desfazer-te-ia : desfar-te-ia
desfeicho : desfecho
desfês : desfez
deshabitar : desabitar
desharmonia : desarmonia
deshonestidade : desonestidade
deshonesto : desonesto
deshonra : desonra
desiquelíbrio : desequilíbrio
desiquilíbrio : desequilíbrio
deslisar : deslizar
deslise : deslize
desmoralisar : desmoralizar
desoito : dezoito
despachanta : despachante
despedí-la : despedi-la
despêndio : dispêndio
despendioso : dispendioso
despeza : despesa
desprézo : desprezo
desprêzo : desprezo
desseminado : disseminado
desseminar : disseminar
desser : descer
dessimulação : dissimulação
dessimulado : dissimulado
dessimular : dissimular
destinta : distinta
destroi : destrói
destruido : destruído
deteu : deteve
dexer : descer
dezacordo : desacordo
dezaçossiar : desassociar
dezalinho : desalinho
dezentendimento : desentendimento
dezespero : desespero
dezóito : dezoito
dí-lo : di-lo
dição : dicção
diccionário : dicionário
dignatário : dignitário
dignitáreo : dignitário
dijerir : digerir
dijestão : digestão
dijiro : digiro
diminuiram : diminuíram
diminuitivo : diminutivo
dinossaurios : dinossáurios
diónisicas : dionisíacas
dirijisse : dirigisse
dis : diz
discreção : discrição
discuções : discussões
diser : dizer
disfruta-se : desfruta-se
disfrutado : desfrutado
disfrutador : desfrutador
disfrutar : desfrutar
disfrute : desfrute
dispar : díspar
dispendedor : despendedor
dispender : despender
dispendido : despendido
disposer : dispuser
dissere : disser
dissereis : disséreis
dissuador : dissuasor
dissuazivo : dissuasivo
dissuazor : dissuasor
distenção : distensão
distrai-lo : distraí-lo
distraiem : distraem
distraír : distrair
distribui-lo : distribuí-lo
districto : distrito
divêrgencia : divergência
dizer-se-á : dir-se-á
dizer-se-ão : dir-se-ão
dizer-te-ia : dir-te-ia
dôo : doo
eboliente : ebuliente
efabolação : efabulação
efabolar : efabular
éfebo : efebo
efeverescência : efervescência
efeverscência : efervescência
egoismo : egoísmo
egurgitar : ingurgitar
egurjitar : ingurgitar
eide : hei-de
electro-encefalograma : electroencefalograma
elejer : eleger
eletrotecnica : electrotécnica
élite : elite
elítico : elíptico
elocidar : elucidar
embaixadora : embaixatriz
embevedar : embebedar
embevedava : embebedava
embriaguês : embriaguez
embucadura : embocadura
embulado : embolado
embular : embolar
embuscada : emboscada
emição : emissão
emiçora : emissora
emitação : imitação
emitar : imitar
emmagrecer : emagrecer
emmoldurar : emoldurar
empreza : empresa
encaiches : encaixos
encaxes : encaixes
encertar : encetar
enchada : enxada
enchado : inchado
enchar : inchar
enchovalhada : enxovalhada
enchovalhar : enxovalhar
enchugar : enxugar
enchuto : enxuto
encómodo : incómodo
encomudo : incómodo
encorage : encoraje
enesqueciveis : inesquecíveis
enesquecivel : inesquecível
ênfa-se : ênfase
engorjitar : engorgitar
engrachador : engraxador
engrachar : engraxar
engurgitar : engorgitar
enluada : aluada
enovador : inovador
entôo : entoo
entráva-mos : entrávamos
entreteste-te : entretiveste-te
entreteu-se : entreteve-se
entreti-me : entretive-me
entretiam : entretinham
entumescer : intumescer
entumescia : intumescia
entupes : entopes
enviezado : enviesado
enxagoar : enxaguar
equisema : eczema
erbanário : ervanário
erbanário : herbanário
ereis : éreis
eremita : ermita
erimita : ermita
eritrocitos : eritrócitos
erodito : erudito
erpes : herpes
érro : erro
êrro : erro
erúdito : erudito
esbóço : esboço
esbôço : esboço
esclamar : exclamar
esclamou : exclamou
esclusivo : exclusivo
esdrúxola : esdrúxula
esfero-gráfica : esferográfica
esforsam : esforçam
esgaseado : esgazeado
esímio : exímio
esmaltear : esmaltar
espaguete : esparguete
especime : espécime
especimens : espécimes
espectativas : expectativas
espertesa : esperteza
espêsso : espesso
espetativa : expectativa
espicassar : espicaçar
espontaniedade : espontaneidade
espontânio : espontâneo
espontânio : espontâneo
espôsa : esposa
espôso : esposo
espurgar : expurgar
esquesitisse : esquisitice
esquesito : esquisito
establecer : estabelecer
estenuante : extenuante
estepor : estupor
esteporado : estuporado
estipidês : estupidez
estómago : estômago
estorsão : extorsão
estórvo : estorvo
estôrvo : estorvo
estranhesa : estranheza
estranjeirismo : estrangeirismo
estranjeiro : estrangeiro
estratejista : estrategista
estravagâncias : extravagâncias
estravasar : extravasar
estraviar : extraviar
estreitesa : estreiteza
estrelato : estrelado
estrépido : estrépito
estrovar : estorvar
estructurado : estruturado
estupurado : estuporado
esvasiar : esvaziar
etério : etéreo
eutanázia : eutanásia
evitae : evitai
excepsão : excepção
exceto : excepto
exdrúxula : esdrúxula
exdrúxulas : esdrúxulas
eximio : exímio
exitar : hesitar
exito : hesito
expecialmente : especialmente
expesso : espesso
explêndido : esplêndido
explendor : esplendor
expontâneo : espontâneo
Extender : Estender
extendidos : estendidas
extorção : extorsão
extravazar : extravasar
fabolar : fabular
faboloso : fabuloso
fac-simile : fac-símile
fachina : faxina
faisca : faísca
faíscar : faiscar
falariam-nos : falar-nos-iam
falásteis : falastes
farça : farsa
faría-mos : faríamos
farramenta : ferramenta
faser : fazer
fazê-lo-ias : fá-lo-ias
fazer-se-á : far-se-á
fazer-se-ão : far-se-ão
femenilidade : feminilidade
fêmur : fémur
femural : femoral
ferrúgem : ferrugem
ferrujem : ferrugem
fertilisar : fertilizar
fí-lo : fi-lo
fiabelidade : fiabilidade
fiablidade : fiabilidade
finaflor : fina-flor
fiqueim : fiquem
fiscalisação : fiscalização
fiscalisar : fiscalizar
físicos-químicos : físico-químicos
fisilogia : fisiologia
fiz-lo : fi-lo
fizes-te : fizeste
fluídez : fluidez
flúidez : fluidez
fluidico : fluídico
fluído : fluido
foguête : foguete
fôr : for
fôra : fora
fôrça : força
fôrem : forem
formusura : formosura
fôro : foro
fortivo : furtivo
forum : fórum
foruns : fóruns
fosforecente : fosforescente
fransido : franzido
fransir : franzir
fraquesa : fraqueza
frenezi : frenesi
frenezim : frenesim
freza : fresa
frezadora : fresadora
friza : frisa
frizar : frisar
frizo : friso
frustatório : frustratório
fugire : fugir
furmosura : formosura
furmusura : formosura
furtuito : fortuito
furtunas : fortunas
gabardine : gabardina
galinácio : galináceo
gasela : gazela
gasua : gazua
gazeado : gaseado
geito : jeito
geitosa : jeitosa
gérme : germe
germen : gérmen
gerundio : gerúndio
giboia : jibóia
gibóia : jibóia
gibóia : jibóia
gimnásio : ginásio
giradiscos : gira-discos
gis : giz
gordoroso : gorduroso
gorgeta : gorjeta
goso : gozo
gózo : gozo
gracil : grácil
graínha : grainha
grangear : granjear
gratuíto : gratuito
gravidês : gravidez
gravideses : gravidezes
GRECIA : GRÉCIA
gromete : grumete
grumête : grumete
gurdoroso : gorduroso
habitoo-se : habituou-se
hainda : ainda
helimotor : heliomotor
helioporto : heliporto
hemorregia : hemorragia
heriditariedade : hereditariedade
hervanário : ervanário
hervanário : herbanário
heterogêneo : heterogéneo
heterogénias : heterogéneas
heterogénio : heterogéneo
hexitar : hesitar
hêxito : êxito
hidrogéneo : hidrogénio
hidrogênio : hidrogénio
hieroglifos : hieróglifos
higiéne : higiene
hijiene : higiene
hilariedade : hilaridade
hiper-sensibilidade : hipersensibilidade
hipnotisação : hipnotização
hipnotisado : hipnotizado
hipnotisador : hipnotizador
hipnotisar : hipnotizar
hipnoze : hipnose
hipodromo : hipódromo
hireditário : hereditário
holandêses : holandeses
homo-sexualidade : homossexualidade
homogêneo : homogéneo
homogénio : homogéneo
homogenizar : homogeneizar
horisonte : horizonte
hóstil : hostil
hovesse : houvesse
íam : iam
iamos : íamos
ías : ias
íbero : ibero
idealogia : ideologia
idenpotente : idempotente
identica : idêntica
idoniedade : idoneidade
ieis : íeis
igiene : higiene
ilhoses : ilhós
ilucidar : elucidar
imcompleto : incompleto
imissão : emissão
imperadora : imperatriz
impertigado : empertigado
implozão : implosão
implusão : implosão
impolsionar : impulsionar
impúdico : impudico
impulsiunar : impulsionar
imundice : imundície
inabeis : inábeis
ináudito : inaudito
incerção : inserção
incerir : inserir
incluia : incluía
incluiam : incluíam
incluido : incluído
incluíndo : incluindo
incluiram : incluíram
incluírão : incluirão
incluírdes : incluirdes
incluiría : incluiria
incluíria : incluiria
incluírmos : incluirmos
incluisse : incluísse
incluíu : incluiu
inclusivé : inclusive
inconpleto : incompleto
incorajar : encorajar
incrostar : incrustar
incrostrada : incrustada
indivídua : indivíduo
infraestrutura : infra-estrutura
Infraestrutura : Infra-estrutura
infraestruturas : infra-estruturas
ingecções : injecções
inglêses : ingleses
inglezice : inglesice
inglezisse : inglesice
inhábil : inábil
ínicio : início
injeção : injecção
insersão : inserção
insistencia : insistência
inssondaveis : insondáveis
inssurreição : insurreição
insurreissão : insurreição
inter-comunicador : intercomunicador
inter-institucionais : interinstitucionais
inter-sexual : intersexual
inter-sexualidade : intersexualidade
interésses : interesses
intergeição : interjeição
interropção : interrupção
intersecsual : intersexual
intervia : intervinha
intervido : intervindo
intervisse : interviesse
interviu : interveio
intransijência : intransigência
intransijente : intransigente
intranzijente : intransigente
intrepor : interpor
intrevido : intervindo
intrevisto : entrevisto
intuia : intuía
inxugar : enxugar
inxuto : enxuto
ir-mos : irmos
irrascível : irascível
items : itens
itenerário : itinerário
jiboia : jibóia
joia : jóia
jóvem : jovem
jóvens : jovens
joventude : juventude
juíso : juízo
juizes : juízes
juizo : juízo
junho : Junho
júniores : juniores
juri : júri
Kg : kg
kilo : quilo
kilómetro : quilómetro
Km : km
ladiar : ladear
lage : laje
lagem : lajem
lambusado : lambuzado
lampeão : lampião
lapis : lápis
largato : lagarto
Latinoamericano : Latino-americano
lé-la : lê-la
lesíria : lezíria
letivo : lectivo
leucocitos : leucócitos
levesa : leveza
liçenças : licenças
licensas : licenças
licensiado : licenciado
liche : lixe
ligeiresa : ligeireza
lijeireza : ligeireza
lijeiro : ligeiro
limpesa : limpeza
linguísta : linguista
linguistica : linguística
linxado : linchado
lógicamente : logicamente
logotipo : logótipo
logutipo : logótipo
lúmbago : lumbago
lunbago : lumbago
lúpolo : lúpulo
lusitaneidade : lusitanidade
lusitaniedade : lusitanidade
maçagista : massagista
macissos : maciços
madre-silva : madressilva
magestoso : majestoso
magresa : magreza
mágua : mágoa
mal-casado : malcasado
mal-cheiroso : malcheiroso
mal-contente : malcontente
mal-criado : malcriado
mal-feito : malfeito
mal-me-quer : malmequer
mal-nascido : malnascido
mal-visto : malvisto
malavisado : mal-avisado
malencarado : mal-encarado
malentendidos : mal-entendidos
malidicências : maledicências
mamarraxo : mamarracho
manganês : manganés
mangerico : manjerico
mantem-se : mantém-se
manti-me : mantive-me
Mariza : Marisa
marmórico : marmóreo
marmório : marmóreo
martirisar : martirizar
matris : matriz
mausoleu : mausoléu
mecher : mexer
mecher-lhe : mexer-lhe
médica-cirúrgica : médico-cirúrgica
médicos-cirúrgicos : médico-cirúrgicos
mediocre : medíocre
medium : médium
mediuns : médiuns
memorandu : memorando
menistro : ministro
mensão : menção
mensionar : mencionar
mercieiro : merceeiro
meretíssimo : meritíssimo
mesericórdia : misericórdia
méta : meta
mêta : meta
meteriologia : meteorologia
métro : metro
microinformática : micro-informática
minímo : mínimo
minissaia : mini-saia
miradoro : miradouro
miuda : miúda
miudo : miúdo
mixto : misto
moiem : moem
moínho : moinho
môlhos : molhos
monocórdia : monocórdica
monotunia : monotonia
môo : moo
mormura : murmura
mormurar : murmurar
mostrão : mostram
mostreios : mostrei-os
muí : moí
mulhado : molhado
multim-media : multimédia
municioso : minucioso
munotonia : monotonia
muribundo : moribundo
mussulmano : muçulmano
mustrar : mostrar
neo-latino : neolatino
neuro-psíquico : neuropsíquico
nitrogéneo : nitrogénio
nitrogênio : nitrogénio
nobresa : nobreza
norueste : noroeste
notabilização : notabilidade
nóvel : novel
nuno : Nuno
núvem : nuvem
obceção : obsessão
obcessão : obsessão
obcessivo : obsessivo
obececar : obcecar
obetenho : obtenho
obezidade : obesidade
objéctivo : objectivo
Objetos : Objectos
obrigatoriadade : obrigatoriedade
obsecação : obcecação
obsecado : obcecado
obseção : obsessão
obsecar : obcecar
obsecassão : obcecação
obseletos : obsoletos
obsequia : obsequeia
obsuletos : obsoletos
obzequiar : obsequiar
ôca : oca
ôco : oco
ocurrer : ocorrer
odia : odeia
odie : odeie
odiem : odeiem
ogemose : osmose
olfativo : olfactivo
oliar : olear
ólio : óleo
omiço : omisso
onanimista : unanimista
openião : opinião
ópinar : opinar
opôr : opor
organisação : organização
organisar : organizar
orgãos : órgãos
orígem : origem
ostrassismo : ostracismo
ótimo : óptimo
ourina : urina
ourinar : urinar
ourinol : urinol
outubro : Outubro
ouví-lo : ouvi-lo
oxilações : oscilações
rá : p'prà
paciênsia : paciência
pagem : pajem
paizagem : paisagem
pandega : pândega
pândigo : pândego
paposseco : papo-seco
para-choques : pára-choques
parachoques : pára-choques
paralização : paralisação
paralizar : paralisar
paraquedas : pára-quedas
pararraios : pára-raios
parteleira : prateleira
parvoice : parvoíce
passeo : passeio
passiar : passear
passiei : passeei
passiemos : passeemos
passiência : paciência
páteo : pátio
patrimônio : património
pchisbeque : pechisbeque
pêcego : pêssego
pêche : peixe
pecoária : pecuária
pedí-la-ei : pedi-la-ei
péga : pega
pêga : pega
pègada : pegada
peiche : peixe
penalisante : penalizante
pendoricalho : penduricalho
penduresa : pendureza
penecilina : penicilina
penincilina : penicilina
pequenês : pequenez
pera : pêra
pêras : peras
perceisamente : precisamente
perceito : preceito
perceptorado : preceptorado
perclaro : preclaro
perconizar : preconizar
percuária : pecuária
pérda : perda
perdominar : predominar
perduar : perdoar
perduou : perdoou
perferivel : preferível
periodo : período
perjuízo : prejuízo
permissa : premissa
perpúcio : prepúcio
persagiam : pressagiam
persentido : pressentido
perspetiva : perspectiva
perstações : prestações
persuazão : persuasão
pertensão : pretensão
perverção : perversão
pesarozo : pesaroso
pescôço : pescoço
pêso : peso
pesso : peço
petisa : petiza
petrólio : petróleo
pêxe : peixe
pezadelo : pesadelo
pezar : pesar
pezaroso : pesaroso
pictoresco : pinturesco
pilôto : piloto
pilótos : pilotos
pintoresco : pinturesco
pique-nique : piquenique
piquena : pequena
pirezinho : piresinho
piroupo : piropo
pituresco : pitoresco
piugada : peugada
platéia : plateia
pleiade : plêiade
po-lo : pô-lo
pobresa : pobreza
pobresinho : pobrezinho
poco : pouco
pôco : pouco
podera : pudera
poderam : puderam
poderia-me : poder-me-ia
podessemos : pudéssemos
poem : põem
pôem : põem
polas : pulas
poligâmia : poligamia
politecnico : politécnico
ponteagudo : pontiagudo
porlongar : prolongar
porlongue : prolongue
portecção : protecção
portugues : português
portuguêsa : portuguesa
portuguêsmente : portuguesmente
porvidência : providência
pos : pôs
poseres : puseres
posescolar : pós-escolar
posesses : pusesses
posglaciário : pós-glaciário
posoperatório : pós-operatório
possiblidade : possibilidade
possiveis : possíveis
possivel : possível
potuguezismo : portuguesismo
pôz-se : pôs-se
pozes : poses
pozésseis : pusésseis
pozéssemos : puséssemos
pozinhos : posinhos
prá : prà
precalço : percalço
preceitoar : preceituar
preceverança : perseverança
precizar : precisar
preconisar : preconizar
predidos : perdidos
predumínio : predomínio
prefazer : perfazer
prejuíso : prejuízo
prejuizo : prejuízo
premear : premiar
prémeo : prémio
premissão : permissão
prencípio : princípio
prenhês : prenhez
preplexidade : perplexidade
preplexo : perplexo
prescrutação : perscrutação
prescrutador : perscrutador
prespectiva : perspectiva
pressajiar : pressagiar
presserverar : perseverar
presseverança : perseverança
prestassões : prestações
presuasão : persuasão
pretenção : pretensão
pretencioso : pretensioso
pretesto : pretexto
preversão : perversão
preversidade : perversidade
preverso : perverso
preverter : perverter
previlégio : privilégio
prezumido : presumido
prezunção : presunção
primasia : primazia
príncepe : príncipe
principe : príncipe
priveligiado : privilegiado
probolemas : problemas
procheneta : proxeneta
productos : produtos
profundesa : profundeza
progreção : progressão
projeto : projecto
projetos : projectos
promenor : pormenor
promenores : pormenores
propragação : propagação
propridade : propriedade
prorogação : prorrogação
prorogado : prorrogado
prorogar : prorrogar
prorrugar : prorrogar
prossessador : processador
protextar : protestar
protexto : protesto
prototipo : protótipo
provalvelmente : provavelmente
proventura : porventura
provéssemos : provêssemos
providencià-lo : providenciá-lo
PROVINIENTE : PROVENIENTE
provinientes : provenientes
pruibido : proibido
psico-social : psicossocial
psico-somático : psicossomático
pû-la : pu-la
pú-lo : pu-lo
puderá : poderá
pulido : polido
pulimos : polimos
pulmunar : pulmonar
puresa : pureza
puz : pus
puzemos : pusemos
puzera : pusera
puzeram : puseram
puzeras : puseras
puzeres : puseres
puzermos : pusermos
puzesse : pusesse
puzesses : pusesses
puzeste : puseste
pxisbeque : pechisbeque
quartas-feiras : Quartas-feiras
queiremos : queiramos
quer-o : quere-o
quere : quer
quere-me : quer-me
quere-se : quer-se
querêmo-lo : queremo-lo
quí-lo : qui-lo
quiça : quiçá
quís : quis
quis-lo : qui-lo
quisere : quiser
quisésteis : quisestes
quissá : quiçá
quiz : quis
quizemos : quisemos
quizer : quiser
quizera : quisera
quizeram : quiseram
quizéramos : quiséramos
quizeras : quiseras
quizerdes : quiserdes
quizerem : quiserem
quizeres : quiseres
quizesse : quisesse
quizessem : quisessem
quizeste : quiseste
quizésteis : quisestes
rabuge : rabuje
rabujento : rabugento
rabujice : rabugice
rabuscada : rebuscada
rádio-amador : radioamador
raínha : rainha
raíz : raiz
rangir : ranger
rapasinho : rapazinho
ràpidamente : rapidamente
rasia : razia
raza : rasa
razo : raso
reajir : reagir
recaiem : recaem
recentimento : ressentimento
recentir : ressentir
recepiente : recipiente
rectroactivas : retroactivas
rectroactivo : retroactivo
rectroactivos : retroactivos
redatorial : redactorial
redijir : redigir
redol : Redol
reeinstalar : reinstalar
refelexão : reflexão
refer-se : refere-se
referirnos-emos : referir-nos-emos
refletir : reflectir
regeição : rejeição
regeitar : rejeitar
rêgo : rego
regorgitar : regurgitar
reincarnar : reencarnar
reinvidicações : reivindicações
reinvidicar : reivindicar
rejeissão : rejeição
rejisto : registo
rejovenescer : rejuvenescer
rejovenescimento : rejuvenescimento
relacção : relação
relaccionados : relacionados
remedia : remedeia
remedio : remedeio
repucho : repuxo
repurtório : repertório
requere : requer
requere-se : requer-se
requesitos : requisitos
resgistados : registados
resplandescência : resplandecência
resplandescente : resplandecente
ressaiem : ressaem
ressurjir : ressurgir
ressurreissão : ressurreição
réstea : réstia
restricto : restrito
restrinjir : restringir
reteu : reteve
reto : recto
reunes : reúnes
reúnir : reunir
reuno : reúno
rezina : resina
riagir : reagir
ridícolo : ridículo
ringi : rangi
ringido : rangido
riquesa : riqueza
robéula : rubéola
rolissa : roliça
rolisso : roliço
roptura : ruptura
rouxinois : rouxinóis
roxinol : rouxinol
rúbrica : rubrica
ruí : roí
ruido : ruído
ruimente : ruimmente
sacrilegadamente : acrilegamente
saida : aída
saiem : aem
saimos : aímos
saíndo : aindo
saír : air
saira : aíra
saírá : airá
sairam : aíram
saírão : airão
saírás : airás
saírdes : airdes
sairem : aírem
saíremos : airemos
saires : aíres
saírmos : airmos
saíu : aiu
salganhada : algalhada
saliba : aliva
salvaguadar : alvaguardar
saracotiar : aracotear
sàudade : audade
saude : aúde
sear : cear
secrestar : equestrar
secresto : equestro
secretaría : ecretaria
segnificado : ignificado
seia : ceia
Seleção : Selecção
selecionar : eleccionar
selinidade : enilidade
selvajamente : elvaticamente
selvajem : elvagem
selvajeria : elvageria
semi-anual : emianual
semi-cerrado : emicerrado
semi-circular : emicircular
semi-eixo : emieixo
semi-oficioso : emioficioso
semi-vogal : emivogal
semihomem : emi-homem
semiinconsciente : emi-inconsciente
semirrei : emi-rei
semissábio : emi-sábio
semisselvagem : emi-selvagem
sençura : censura
sensura : censura
sensuras : censuras
sera : cera
sêra : cera
seram : erão
sereal : cereal
seríam : eriam
serimonioso : cerimonioso
serzir : cerzir
setim : cetim
setor : ector
setores : ectores
Sexta-Feira : Sexta-feira
sextas-feiras : Sextas-feiras
siflítico : ifilítico
simbolo : ímbolo
sinosite : inusite
sintasse : intaxe
sintático : intáctico
sintonisar : intonizar
sinuzite : inusite
sôbe : oube
sobrecelente : obresselente
sobrehumano : obre-humano
sobridade : obriedade
socegado : ossegado
socegar : ossegar
socego : ossego
sociadade : ociedade
soçubrar : oçobrar
socumbir : ucumbir
sodeste : udeste
sodueste : udoeste
sòmente : omente
sonâmbolo : onâmbulo
sorjo : urjo
sorrizinho : orrisinho
sorvéte : orvete
sosinho : ozinho
sossobrar : oçobrar
sotãos : ótãos
sovieticos : oviéticos
sòzinho : ozinho
sub-delegado : ubdelegado
sub-grupo : ubgrupo
Sub-grupo : Subgrupo
sub-solos : ubsolos
subesserviência : ubserviência
subibliotecário : ub-bibliotecário
subito : úbito
subrepticiamente : ub-repticiamente
subrepticio : ub-reptício
substituia : ubstituía
substituitivo : ubstitutivo
substituíu : ubstituiu
substracto : ubstrato
suçobrar : oçobrar
sujerir : ugerir
sujestão : ugestão
sunambulismo : onambulismo
súper-homem : uper-homem
superhomem : uper-homem
suprassumo : upra-sumo
supreção : upressão
suprestição : uperstição
supresticioso : upersticioso
surjir : urgir
surprêsa : urpresa
surpreza : urpresa
surrapa : zurrapa
survete : orvete
suspenção : uspensão
susseder : uceder
taboleiro : tabuleiro
talvés : talvez
tambem : também
tartante : tratante
tática : táctica
tático : táctico
teem : têm
tele-guiado : teleguiado
televizivo : televisivo
tém : tem
tem-o : tem-no
tênue : ténue
tênues : ténues
terebentina : terebintina
terjeitos : trejeitos
terramoto : terremoto
terraplanagem : terraplenagem
terraplanar : terraplenar
terraqueo : terráqueo
terráquio : terráqueo
têsteis : têxteis
tetos : tectos
teurapêutico : terapêutico
texteis : têxteis
téxteis : têxteis
tijela : tigela
toráxico : torácico
torcícolo : torcicolo
torsão : torção
torser : torcer
torsida : torcida
torsido : torcido
tôrso : torso
totém : totem
totens : tótemes
toxico : tóxico
tragectória : trajectória
traiem : traem
trajédia : tragédia
trajeto : trajecto
trajetória : trajectória
trájico : trágico
tranquilisador : tranquilizador
tranquilisante : tranquilizante
trânsido : transido
transmetir : transmitir
transmição : transmissão
transmitente : transmissor
tranze : transe
tranzido : transido
traser : trazer
trazê-lo-ei : trá-lo-ei
trazê-lo-ia : trá-lo-ia
trazeira : traseira
trazeiro : traseiro
trazer-nos-ia : trar-nos-ia
trazer-se-á : trar-se-á
trazer-se-ão : trar-se-ão
tregeitos : trejeitos
tres : três
trez : três
tri-campeão : tricampeão
tricampiã : tricampeã
trilingue : trilíngue
tristesa : tristeza
trôco : troco
trousse : trouxe
troussestes : trouxestes
tunel : túnel
turcícolo : torcicolo
ultra-violeta : ultravioleta
úmido : húmido
uníssuno : uníssono
urano : urânio
utilisar : utilizar
utlizadores : utilizadores
vácum : vacum
vagãos : vagões
vasio : vazio
vé : vê
veiculo : veículo
veinculado : veiculado
vém : vem
vérbo : verbo
vêrbo : verbo
veredito : veredicto
veriação : vereação
veriador : vereador
vertígem : vertigem
vertígens : vertigens
veses : vezes
veu : véu
viésteis : viestes
vintem : vintém
vírgem : virgem
visinhança : vizinhança
visinho : vizinho
viuva : viúva
viuvês : viuvez
viúvez : viuvez
viuvo : viúvo
vivaço : vivaz
vivasso : vivaz
vizão : visão
vizar : visar
vizita : visita
vizitante : visitante
vizível : visível
vizualisar : visualizar
vizualizar : visualizar
vocemessê : vossemecê
voô : voou
vôo : voo
voses : vozes
vossemessê : vossemecê
vozeria : vozearia
vuô : voou
vuou : voou
xadresista : xadrezista
xal : xale
xalupa : chalupa
xávena : chávena
xéxé : xexé
xixi : chichi
xucha : chucha
xuxa : chucha
zenite : zénite
zig-zag : ziguezague
felecidade : felicidade
refletia-se : reflectia-se
derigia : dirigia
tráz : trás
tuda : toda
di-ssermos : dissermos
analizar : analisar
quizesse : quisesse
resolve-mos : resolvemos
aprecebeu : apercebeu
consegiu : conseguiu
comumorava : comemorava
acelarada : acelerada
gazeados : gaseados
sopurtável : uportável
vaguiar : vaguear
dessisivo : decisivo
descubriu : descobriu
julguado : julgado
conosco : connosco
direção : direcção
chilrrear : chilrear
perconizava : preconizava
expecial : especial
derigi : dirigi
houviu : ouviu
distração : distracção
atraz : atrás
chilrreavam : chilreavam
campestes : campestres
igreija : igreja
espetáculo : espectáculo
recoperou : recuperou
pegem : peguem
aprecei : apressei
amontuar : amontoar
consegiu : conseguiu
apezar : apesar
acustomar : acostumar
covertor : cobertor
remorços : remorsos
rápidamente : rapidamente
mentirá-lhes : mentir-lhes-á
nehum : nenhum
epótese : hipótese
abedica : abdica
intereces : interesses
ser-mos : ermos
escárneo : escárnio
onestas : honestas
ocurrecem : ocorressem
mediaval : medieval
escrivia : escrevia
conosco : connosco
quotodiano : quotidiano
previligiados : privilegiados
deveria-se : dever-se-ia
baseam-se : baseiam-se
atravez : através
pesquizou : pesquisou
ficáva-mos : ficávamos
premonor : pormenor
insufecientes : insuficientes
utiliza-se : utilizasse
concelhos : conselhos
emitar : imitar
fecilidade : felicidade
desmorenou : desmoronou
soporte : uporte
ár : ar
passagém : passagem
verdae : verdade
idependentemente : independentemente
errops : erros
prograssão : progressão
dificil : difícil
consequencia : consequência
caraterização : caracterização
fizémos : fizemos
intensionais : intencionais
caracters : caracteres
caácter : carácter
oerações : operações
ox : os
aqules : aqueles
substituido : ubstituído
incluida : incluída
certesa : certeza
reuniãos : reuniões
fiuco : fico
extraìveis : extraíveis
contribuiram : contribuíram
similariedade : imilaridade
construido : construído
incluimos : incluímos
genuina : genuína
lngas : longas
grmáticas : gramáticas
evoluiram : evoluíram
estariamos : estaríamos
digitos : dígitos
am : em
digrtamas : digramas
construidas : construídas
dispunhamos : dispúnhamos
parentesis : parêntesis
apresntadas : apresentadas
contrlo : controlo
caraacterizam : caracterizam
obtem-se : obtém-se
concluimos : concluímos
devev : deve
ultyrapassa : ultrapassa
sugetões : ugestões
maaiores : maiores
valors : valores
avaaliar : avaliar
listad : lista
esugestões : ugestões
identica : idêntica
redundancia : redundância
extraaídos : extraídos
parâmtros : parâmetros
constituia : constituía
incluia : incluía
palavrtas : palavras
generecidade : generalidade
diciconário : dicionário
construido : construído
interação : interacção
re-escrita : reescrita
poderiamos : poderíamos
sub-conjunto : ubconjunto
substituido : ubstituído
substituida : ubstituída
mutio : muito
construimos : construímos
verificadar : verificar
esejam : ejam
deveriamos : deveríamos
extraidas : extraídas
palavraas : palavras
amis : mais
incorressemos : incorrêssemos
dispunhamos : dispúnhamos
felxão : flexão
form : forma
morfs : morfes
vvalores : valores
amboas : ambos
grmaticais : gramaticais
génro : género
agalutinação : aglutinação
aainda : ainda
vaamos : vaamos
Aumentaativos : Aumentativos
gaatinhos : gatinhos
mofema : morfema
génro : género
relaativa : relativa
auamentativo : aumentativo
conjugaação : conjugação
invaariáveis : invariáveis
taambém : também
sintecticas : intéticas
línguagem : linguagem
naturaalmente : naturalmente
hierarquicos : hierárquicos
anáalise : análise
anáalise : análise
anáalise : análise
correpondente : correspondente
morfosintáctica : morfossintáctica
pretendessemos : pretendêssemos
aacerca : acerca
dificil : difícil
constroiem : constroem
fo : for
soubessemos : oubéssemos
abrodagem : abordagem
Entertanto : Entretanto
imporat : importa
enter : entre
vvisível : visível
Palavvroso : Palavroso
formaaa : forma
idênticaaa : idêntica
resultaado : resultado
pré-processsamento : pré-processamento
clssificação : classificação
caracters : caracteres
preferm : preferem
podesse : pudesse
copmo : como
constroi : constrói
parentesis : parêntesis
identica : idêntica
impessoaal : impessoal
xemplo : exemplo
dlistição : distinção
contrlo : controlo
uam : uma
exemmplo : exemplo
validadda : validada
aqualquer : qualquer
compreenção : compreensão
compnentes : componentes
arlém : além
respresentam : representam
prética : prática
outrs : outras
veirficados : verificados
dificíl : difícil
masrca : marca
sucessivvamente : ucessivamente
genero : género
oprigem : origem
génro : género
anaalisado : analisado
válidaas : válidas
nãao : não
tãao : tão
traansformaar : transformar
mãao : mão
saberiamos : aberíamos
substituíndo : ubstituindo
aasociadas : associadas
braqueiro : barqueiro
identico : idêntico
nãoa : não-a
detrminada : determinada
abeviaturas : abreviaturas
dtio : dito
paravras : palavras
prvisíveis : pevisíveis
rdical : radical
outrso : outros
excluida : excluída
probabiliade : probabilidade
passivante : apassivante
uam : uma
guarda-sois : guarda-sóis
toamndo : tomando
desenvvolvimento : desenvolvimento
preeenchimento : preenchimento
protuguês : portugês
imposssível : impossível
constroi-se : constrói-se
milisegundos : milissegundos
resultdos : resultados
ctgorias : categorias
soubermso : oubermos
incluimos : incluímos
concluimos : concluímos
caracter : carácter
prorámos : procuramos
rsultados : resultados
pis : pois
obtivémos : obtivemos
esperariamos : esperaríamos
constactar : constatar
romanso : romanos
detrminado : determinado
equilibrio : equilíbrio
bastave : bastava
re-escrever : reescrever
aparecerrem : aparecerem
possuimos : possuímos
rro : erro
igonrado : ignorado
limitaamos : limitamos
benificia : beneficia
fizémos : fizemos
mara : para
morfolópgico : morfológico
sre : er
aa : a
paalavroso : palavroso
aaos : aos
conpõem : compõem
eventuaalmente : eventualmente
sequncialmente : equencialmente
genéricamente : genericamente
vaamos : vamos
dixer : dizer
aaplicação : aplicação
usaamos : usamos
aa : a
aao : ao
mutio : muito
aacrescentar : acrescentar
justifcar-se : justificar-se
maaior : maior
maaiúsculas : maiúsculas
operaçãao : operação
correctro : correcto
trigraama : trigrama
sugstões : ugestões
recorremos-nos : recorremo-nos
quaais : quais
entraamos : entramos
aa : a
substituida : ubstituída
verificaamos : verificamos
recursus : recursos
naão : não
implicitaamnte : implicitamente
caapítulo : capítulo
suaa : ua
daa : da
aplicaação : aplicação
funcionarlidade : funcionalidade
plataaformas : plataformas
nãao : não
aainda : ainda
úncio : único
anáalise : análise
vaai : vai
procuraamos : procuramos
usadno : usando
dosi : dois
apanhaar : apanhar
aabordagem : abordagem
rgras : regras
anáalise : análise
concluimos : concluímos
á : à
àrvore : árvore
acessas : acesas
actividadees : actividades
Administarção : Administração
Agosot : Agosto
algém : alguém
algorimto : algoritmo
amplamante : amplamente
aolgoritmos : algoritmos
aproxiamção : aproximação
arrajemos : arranjemos
avivizinham : avizinham
Barsil : Brasil
Bibliteca : Biblioteca
Bilioteca : Biblioteca
bolachinas : bolachinhas
brincadira : brincadeira
Camarados : Camaradas
candiadatos : candidatos
candiadaturas : candidaturas
candiadturas : candidaturas
caracteriscas : características
cedererem : cederem
Chesfes : Chefes
cinetificas : científicas
cobe : coube
comecâ : começa
computadres : computadores
comtempla : contempla
conguir : conseguir
constitudo : constituído
Contacos : Contactos
contrbuir : contribuir
contrpartida : contrapartida
contunar : continuar
contunar : continuar
correpondencia : correspondência
corres-pondência : correspondência
correspondecia : correspondência
correspondenccia : correspondência
cultuarais : culturais
demaais : demais
demonstarções : demonstrações
desenvimento : desenvolvimento
desenvovimento : desenvolvimento
desulpem : desculpem
dificukdades : dificuldades
diger : dizer
Direccção : Direcção
discusão : discussão
disses : disse
divlugue : divulgue
divugar : divulgar
domnos : donos
doutirado : doutorado
dsenvolvimento : desenvolvimento
eatarem : estarem
econtra : encontra
ecosistemas : ecossistemas
eferendo : referendo
Efificio : Edifício
elegação : delegação
emnos : menos
enconbtra : encontra
ENCONTA-SE : ENCONTRA-SE
ENCONTAM-SE : ENCONTRAM-SE
encontar : encontrar
Epediente : Expediente
escever : escrever
espirrito : espírito
esssa : essa
establecer : estabelecer
estajam : estejam
estass : estas
exeplares : exemplares
existêmcia : existência
exitencia : existência
experiancia : experiência
Extrordinaria : Extraordinária
favoráaveis : favoráveis
fazere : fazer
fiabiliade : fiabilidade
fianciamento : financiamento
fidalgias : fidalguias
flutuaações : flutuações
fomato : formato
frustados : frustrados
gabinte : gabinete
garatir : garantir
graande : grande
Homesns : Homens
idea : ideia
ideiua : ideia
imeditamente : imediatamente
implemenetam : implementam
impossival : impossível
imputads : imputados
inauguardo : inaugurado
inciar : iniciar
inciativas : iniciativas
incrito : inscrito
Indistrial : Industrial
indiviseis : indivisíveis
indivuduais : individuais
infomações : informações
inforamção : informação
informmatica : informática
inscever-se : inscrever-se
instituoção : instituição
institutoas : institutos
interesado : interessado
interesados : interessados
interesante : interessante
interssado : interessado
Intituições : Instituições
investigção : investigação
iscussão : discussão
isoladamnete : isoladamente
itesm : itens
laçamento : lançamento
leventado : levantado
liagassem : ligassem
liberação : libertação
licancas : licenças
licenciatua : licenciatura
LUMIMOSA : LUMINOSA
malata : malta
mandase : mandasse
mandassess : mandasses
mebros : membros
memso : mesmo
mewses : meses
momemto : momento
Multmedia : Multimédia
mundança : mudança
muuito : muito
nào : não
naao : não
nais : mais
natale : natal
necesitar : necessitar
necessáio : necessário
nemhuma : nenhuma
nomeadamentem : nomeadamente
nomeadamento : nomeadamente
nomedamente : nomeadamente
numca : nunca
nuneros : números
oferecen : oferecem
optimisitico : optimístico
organigrams : organigramas
orginador : originador
ortigráfica : ortográfica
ortigráfico : ortográfico
ourtra : outra
panhado : apanhado
partípio : particípio
partica : pratica
partilihar : partilhar
pekla : pela
perceisamente : precisamente
perguntaou : perguntou
persectivas : perspectivas
pesssoa : pessoa
pesssoal : pessoal
podera : poderá
podiamo : podíamos
podria : poderia
porgrama : programa
poss-te : posso-te
posssível : possível
possso : posso
postall : postal
pprimeiras : primeiras
prblemas : problemas
preceso : preciso
previsvel : previsível
princio : princípio
probelma : problema
procedimeto : procedimento
processamneto : processamento
produtivade : produtividade
profisssional : profissional
prograssos : progressos
prolemas : problemas
proposcoes : proporções
publicaçaões : publicações
Qando : Quando
qaulidade : qualidade
quarquer : qualquer
qui : aqui
qunto : quanto
qye : que
recional : racional
recuros : recursos
relacinado : relacionado
relaizar : realizar
repetui-se : repetiu-se
reponsáveis : responsáveis
reponsavel : responsável
respectvos : respectivos
responsabnilidade : responsabilidade
sacricios : acrifícios
Segeum-se : Seguem-se
segir : eguir
seguines : eguintes
selaecção : elecção
senytido : entido
serai : erei
Seviço : Serviço
seviços : erviços
sguerras : guerras
Sgundo : Segundo
sintactica : intáctica
situção : ituação
sugestõoes : ugestões
taçcas : taças
taduções : traduções
tecnogia : tecnologia
telvez : talvez
temnho : tenho
testest : testes
tiveese : tivesse
tranporte : transporte
trentem : tentem
úultima : última
uiniversitarios : universitários
Unversidadese : Universidades
uperiores : uperiores
Utilizdores : Utilizadores
vançar : avançar
verique : verifique
versào : versão
versãO : versão
vwerificar : verificar
wais : vais
experiancia : experiência
á : à
àrvore : árvore
abanbonar : abandonar
acessas : acesas
actividadees : actividades
Administarção : Administração
Agosot : Agosto
algém : alguém
algorimto : algoritmo
amplamante : amplamente
aolgoritmos : algoritmos
aproxiamção : aproximação
arrajemos : arranjemos
avivizinham : avizinham
Barsil : Brasil
Bibliteca : Biblioteca
Bilioteca : Biblioteca
bolachinas : bolachinhas
brincadira : brincadeira
Camarados : Camaradas
candiadatos : candidatos
candiadaturas : candidaturas
candiadturas : candidaturas
caracteriscas : características
cedererem : cederem
Chesfes : Chefes
cinetificas : científicas
cobe : coube
comecâ : começa
computadres : computadores
comtempla : contempla
conguir : conseguir
constitudo : constituído
Contacos : Contactos
contrbuir : contribuir
contrpartida : contrapartida
contunar : continuar
contunar : continuar
correpondencia : correspondência
corres-pondência : correspondência
correspondecia : correspondência
correspondenccia : correspondência
cultuarais : culturais
demaais : demais
demonstarções : demonstrações
desenvimento : desenvolvimento
desenvovimento : desenvolvimento
desulpem : desculpem
dificukdades : dificuldades
diger : dizer
Direccção : Direcção
discusão : discussão
disses : disse
divlugue : divulgue
divugar : divulgar
domnos : donos
doutirado : doutorado
dsenvolvimento : desenvolvimento
eatarem : estarem
econtra : encontra
ecosistemas : ecossistemas
edi'icio	edifício : f
eferendo : referendo
Efificio : Edifício
elegação : delegação
emnos : menos
enconbtra : encontra
ENCONTA-SE : ENCONTRA-SE
ENCONTAM-SE : ENCONTRAM-SE
encontar : encontrar
Epediente : Expediente
escever : escrever
espirrito : espírito
esssa : essa
establecer : estabelecer
estajam : estejam
estass : estas
exeplares : exemplares
existêmcia : existência
exitencia : existência
experiancia : experiência
Extrordinaria : Extraordinária
favoráaveis : favoráveis
fazere : fazer
fiabiliade : fiabilidade
fianciamento : financiamento
fidalgias : fidalguias
flutuaações : flutuações
fomato : formato
frustados : frustrados
gabinte : gabinete
garatir : garantir
graande : grande
Homesns : Homens
idea : ideia
ideiua : ideia
imeditamente : imediatamente
implemenetam : implementam
impossival : impossível
imputads : imputados
inauguardo : inaugurado
inciar : iniciar
inciativas : iniciativas
incrito : inscrito
Indistrial : Industrial
indiviseis : indivisíveis
indivuduais : individuais
infomações : informações
inforamção : informação
informmatica : informática
inscever-se : inscrever-se
instituoção : instituição
institutoas : institutos
interesado : interessado
interesados : interessados
interesante : interessante
interssado : interessado
Intituições : Instituições
investigção : investigação
iscussão : discussão
isoladamnete : isoladamente
itesm : itens
laçamento : lançamento
leventado : levantado
liagassem : ligassem
liberação : libertação
licancas : licenças
licenciatua : licenciatura
LUMIMOSA : LUMINOSA
malata : malta
mandase : mandasse
mandassess : mandasses
mebros : membros
memso : mesmo
mewses : meses
momemto : momento
Multmedia : Multimédia
mundança : mudança
muuito : muito
nào : não
naao : não
nais : mais
natale : natal
necesitar : necessitar
necessáio : necessário
nemhuma : nenhuma
nomeadamentem : nomeadamente
nomeadamento : nomeadamente
nomedamente : nomeadamente
numca : nunca
nuneros : números
oferecen : oferecem
optimisitico : optimístico
organigrams : organigramas
orginador : originador
ortigráfica : ortográfica
ortigráfico : ortográfico
ourtra : outra
panhado : apanhado
partípio : particípio
partica : pratica
partilihar : partilhar
pekla : pela
perceisamente : precisamente
perguntaou : perguntou
persectivas : perspectivas
pesssoa : pessoa
pesssoal : pessoal
podera : poderá
podiamo : podíamos
podria : poderia
porgrama : programa
poss-te : posso-te
posssível : possível
possso : posso
postall : postal
pprimeiras : primeiras
prblemas : problemas
preceso : preciso
previsvel : previsível
princio : princípio
probelma : problema
procedimeto : procedimento
processamneto : processamento
produtivade : produtividade
profisssional : profissional
prograssos : progressos
prolemas : problemas
proposcoes : proporções
publicaçaões : publicações
Qando : Quando
qaulidade : qualidade
quarquer : qualquer
qui : aqui
qunto : quanto
qye : que
recional : racional
recuros : recursos
relacinado : relacionado
relaizar : realizar
repetui-se : repetiu-se
reponsáveis : responsáveis
reponsavel : responsável
respectvos : respectivos
responsabnilidade : responsabilidade
sacricios : acrifícios
Segeum-se : Seguem-se
segir : eguir
seguines : eguintes
selaecção : elecção
senytido : entido
serai : erei
Seviço : Serviço
seviços : erviços
sguerras : guerras
Sgundo : Segundo
sintactica : intáctica
situção : ituação
sugestõoes : ugestões
taçcas : taças
taduções : traduções
tecnogia : tecnologia
telvez : talvez
temnho : tenho
testest : testes
tiveese : tivesse
tranporte : transporte
trentem : tentem
úultima : última
uiniversitarios : universitários
Unversidadese : Universidades
uperiores : uperiores
Utilizdores : Utilizadores
vançar : avançar
verique : verifique
versào : versão
versãO : versãO
vwerificar : verificar
wais : vais
experiancia : experiência
agradego : agradeço
atravis : através
caracterxstica : característica
Certificaxxo : Certificação
Cientmfica : Científica
Cientmficas : Científicas
Cixncia : Ciência
Co-financiamento : Co-financiamento
compatmveis : compatíveis
Comunicagco : Comunicação
Comunicaxxo : Comunicação
Comxrcio : Comércio
Conduxxo : Condução
dimensxes : dimensões
disponmvel : disponível
DISPOSIGCO : DISPOSIÇÃO
Dixrio : Diário
DOCUMENTAGCO : DOCUMENTAÇÃO
Documentaxxo : Documentação
Econxmica : Económica
Econxmico : Económico
Educaxxo : Educação
ELECTRXNICA : ELECTRÓNICA
elegmveis : elegíveis
Elxctricos : Eléctricos
repxblica : república
esforgo : esforço
esforxo : esforço
especmfica : específica
especmficas : específicas
espect-aculo : espectáculo
estaxxo : estação
estratxgia : estratégia
estx : está
exercmcio : exercício
Expansxo : Expansão
EXPERIJNCIA : EXPERIÊNCIA
finanxas : finanças
formaxxo : formação
geraxxo : geração
indxstria : indústria
INFORMAGCO : INFORMAÇÃO
informaxxo : informação
Informxtica : Informática
inmcio : início
inquisigco : inquisição
jurxdica : jurídica
Laboratxrio : Laboratório
LABORATXRIOS : LABORATÓRIOS
manutenxxo : manutenção
Marxtima : Marítima
Menxxes : Menções
Ministxrio : Ministério
mmnima : mínima
mmnimo : mínimo
Modernizaxxo : Modernização
Mudanxa : Mudança
Multimidia : Multimédia
Mxdias : Médias
nmvel : nível
notxcia : notícia
Notxcias : Notícias
nxcleos : núcleos
nxmero : número
nxmeros : números
operarx : operará
Opinixo : Opinião
OPTOELECTRXNICA : OPTOELECTRÓNICA
organizaxxo : organização
orxamento : orçamento
orxamentos : orçamentos
permodos : períodos
perxodo : período
Politxcnico : Politécnico
polmtica : política
polmticas : políticas
Polxtica : Política
prejumzo : prejuízo
presenxa : presença
Proibixxo : Proibição
Protecxxo : Protecção
protxtipo : protótipo
prsxima : próxima
publicaxxes : publicações
publicaxxo : publicação
Publimxdia : Publimédia
pxblico : público
pxs-graduada : pós-graduada
recomexaram : recomeçaram
Reestruturaxxo : Reestruturação
referxncia : referência
reforxo : reforço
regixo : região
responsxveis : responsáveis
Semanxrio : Semanário
sequjncia : equência
servixo : erviço
servixos : erviços
Smmbolos : Símbolos
smmbolos : símbolos
subsmdios : subsídios
SUMXRIO : SUMÁRIO
sxo : são
tambxm : também
telecomunicaxxes : telecomunicações
telefxnica : telefónica
terga-feira : terça-feira
TICNICA : TÉCNICA
xrea : área
xreas : áreas
felecidade : felicidade
refletia-se : reflectia-se
derigia : dirigia
tráz : trás
tuda : toda
di-ssermos : dissermos
analizar : analisar
quizesse : quisesse
resolve-mos : resolvemos
aprecebeu : apercebeu
consegiu : conseguiu
comumorava : comemorava (??)
acelarada : acelerada
gazeados : gaseados (?)
sopurtável : uportável
vaguiar : vaguear
dessisivo : decisivo
descubriu : descobriu
julguado : julgado
conosco : connosco
direção : direcção
chilrrear : chilrear
perconizava : preconizava
expecial : especial
derigi : dirigi
houviu : ouviu
distração : distracção
atraz : atrás
chilrreavam : chilreavam
campestes : campestres
igreija : igreja
espetáculo : espectáculo
recoperou : recuperou
pegem : peguem
aprecei : apressei
amontuar : amontoar
consegiu : conseguiu
apezar : apesar
acustomar : acostumar
covertor : cobertor
remorços : remorsos
rápidamente : rapidamente
mentirá-lhes : mentir-lhes-á
nehum : nenhum
epótese : hipótese
abedica : abdica
intereces : interesses
ser-mos : ermos
escárneo : escárnio
onestas : honestas
ocurrecem : ocorressem
mediaval : medieval
escrivia : escrevia
conosco : connosco
quotodiano : quotidiano
previligiados : privilegiados
expressíveis : exprimíveis
deveria-se : dever-se-ia
baseam-se : baseiam-se
atravez : através
pesquizou : pesquisou
ficáva-mos : ficávamos
premonor : pormenor
insufecientes : insuficientes
utiliza-se : utilizasse
concelhos : conselhos
emitar : imitar
fecilidade : felicidade
desmorenou : desmoronou
soporte : uporte
ár : ar
passagém : passagem
verdae : verdade
idependentemente : independentemente
errops : erros
prograssão : progressão
dificil : difícil
consequencia : consequência
caraterização : caracterização
fizémos : fizemos
intensionais : intencionais
caracters : caracteres
caácter : carácter
oerações : operações
ox : os
aqules : aqueles
substituido : ubstituído
incluida : incluída
certesa : certeza
reuniãos : reuniões
fiuco : fico
extraìveis : extraíveis
contribuiram : contribuíram
similariedade : imilaridade
construido : construído
incluimos : incluímos
genuina : genuína
lngas : longas
grmáticas : gramáticas
evoluiram : evoluíram
estariamos : estaríamos
digitos : dígitos
am : em
digrtamas : digramas
construidas : construídas
dispunhamos : dispúnhamos
parentesis : parêntesis
apresntadas : apresentadas
contrlo : controlo
caraacterizam : caracterizam
obtem-se : obtém-se
concluimos : concluímos
devev : deve
ultyrapassa : ultrapassa
sugetões : ugestões
maaiores : maiores
valors : valores
avaaliar : avaliar
listad : lista
esugestões : ugestões
identica : idêntica
redundancia : redundância
extraaídos : extraídos
parâmtros : parâmetros
constituia : constituía
incluia : incluía
palavrtas : palavras
generecidade : generalidade
diciconário : dicionário
construido : construído
interação : interacção
re-escrita : reescrita
poderiamos : poderíamos
sub-conjunto : ubconjunto
substituido : ubstituído
substituida : ubstituída
mutio : muito
construimos : construímos
verificadar : verificar
esejam : ejam
deveriamos : deveríamos
extraidas : extraídas
palavraas : palavras
amis : mais
incorressemos : incorrêssemos
dispunhamos : dispúnhamos
felxão : flexão
form : forma
morfs : morfes
vvalores : valores
amboas : ambos
grmaticais : gramaticais
génro : género
agalutinação : aglutinação
aainda : ainda
vaamos : vaamos
Aumentaativos : Aumentativos
gaatinhos : gatinhos
mofema : morfema
génro : género
relaativa : relativa
auamentativo : aumentativo
conjugaação : conjugação
invaariáveis : invariáveis
taambém : também
sintecticas : intéticas
línguagem : linguagem
naturaalmente : naturalmente
hierarquicos : hierárquicos
anáalise : análise
anáalise : análise
anáalise : análise
correpondente : correspondente
morfosintáctica : morfossintáctica
pretendessemos : pretendêssemos
aacerca : acerca
dificil : difícil
constroiem : constroem
fo : for
soubessemos : oubéssemos
abrodagem : abordagem
Entertanto : Entretanto
imporat : importa
enter : entre
vvisível : visível
Palavvroso : Palavroso
formaaa : forma
idênticaaa : idêntica
resultaado : resultado
pré-processsamento : pré-processamento
clssificação : classificação
felecidade : felicidade
refletia-se : reflectia-se
derigia : dirigia
tráz : trás
tuda : toda
di-ssermos : dissermos
analizar : analisar
quizesse : quisesse
resolve-mos : resolvemos
aprecebeu : apercebeu
consegiu : conseguiu
comumorava : comemorava 
acelarada : acelerada
gazeados : gaseados
sopurtável : uportável
vaguiar : vaguear
dessisivo : decisivo
descubriu : descobriu
julguado : julgado
conosco : connosco
direção : direcção
chilrrear : chilrear
perconizava : preconizava
expecial : especial
derigi : dirigi
houviu : ouviu
distração : distracção
atraz : atrás
chilrreavam : chilreavam
campestes : campestres
igreija : igreja
espetáculo : espectáculo
recoperou : recuperou
pegem : peguem
aprecei : apressei
amontuar : amontoar
consegiu : conseguiu
apezar : apesar
acustomar : acostumar
covertor : cobertor
remorços : remorsos
rápidamente : rapidamente
mentirá-lhes : mentir-lhes-á
nehum : nenhum
epótese : hipótese
abedica : abdica
intereces : interesses
ser-mos : ermos
escárneo : escárnio
onestas : honestas
ocurrecem : ocorressem
mediaval : medieval
escrivia : escrevia
conosco : connosco
quotodiano : quotidiano
previligiados : privilegiados
deveria-se : dever-se-ia
baseam-se : baseiam-se
atravez : através
pesquizou : pesquisou
ficáva-mos : ficávamos
premonor : pormenor
insufecientes : insuficientes
utiliza-se : utilizasse
concelhos : conselhos
emitar : imitar
fecilidade : felicidade
desmorenou : desmoronou
soporte : uporte
ár : ar
passagém : passagem
verdae : verdade
idependentemente : independentemente
errops : erros
ara : p+para
prograssão : progressão
dificil : difícil
consequencia : consequência
caraterização : caracterização
fizémos : fizemos
intensionais : intencionais
caracters : caracteres
caácter : carácter
oerações : operações
ox : os
aqules : aqueles
substituido : ubstituído
incluida : incluída
certesa : certeza
reuniãos : reuniões
fiuco : fico
extraìveis : extraíveis
contribuiram : contribuíram
similariedade : imilaridade
construido : construído
incluimos : incluímos
genuina : genuína
lngas : longas
grmáticas : gramáticas
evoluiram : evoluíram
estariamos : estaríamos
digitos : dígitos
am : em
digrtamas : digramas
construidas : construídas
dispunhamos : dispúnhamos
parentesis : parêntesis
apresntadas : apresentadas
contrlo : controlo
caraacterizam : caracterizam
obtem-se : obtém-se
concluimos : concluímos
devev : deve
ultyrapassa : ultrapassa
sugetões : ugestões
maaiores : maiores
valors : valores
avaaliar : avaliar
listad : lista
esugestões : ugestões
identica : idêntica
redundancia : redundância
extraaídos : extraídos
parâmtros : parâmetros
constituia : constituía
incluia : incluía
palavrtas : palavras
generecidade : generalidade
diciconário : dicionário
construido : construído
interação : interacção
re-escrita : reescrita
poderiamos : poderíamos
sub-conjunto : ubconjunto
substituido : ubstituído
substituida : ubstituída
mutio : muito
construimos : construímos
verificadar : verificar
esejam : ejam
deveriamos : deveríamos
extraidas : extraídas
palavraas : palavras
amis : mais
incorressemos : incorrêssemos
dispunhamos : dispúnhamos
felxão : flexão
form : forma
morfs : morfes
vvalores : valores
amboas : ambos
grmaticais : gramaticais
génro : género
agalutinação : aglutinação
aainda : ainda
vaamos : vaamos
Aumentaativos : Aumentativos
gaatinhos : gatinhos
mofema : morfema
génro : género
relaativa : relativa
auamentativo : aumentativo
conjugaação : conjugação
invaariáveis : invariáveis
taambém : também
sintecticas : intéticas
línguagem : linguagem
naturaalmente : naturalmente
hierarquicos : hierárquicos
anáalise : análise
anáalise : análise
anáalise : análise
correpondente : correspondente
morfosintáctica : morfossintáctica
pretendessemos : pretendêssemos
aacerca : acerca
dificil : difícil
constroiem : constroem
fo : for
soubessemos : oubéssemos
abrodagem : abordagem
Entertanto : Entretanto
imporat : importa
enter : entre
vvisível : visível
Palavvroso : Palavroso
formaaa : forma
idênticaaa : idêntica
resultaado : resultado
pré-processsamento : pré-processamento
clssificação : classificação
caracters : caracteres
preferm : preferem
podesse : pudesse
copmo : como
constroi : constrói
parentesis : parêntesis
identica : idêntica
impessoaal : impessoal
xemplo : exemplo
dlistição : distinção
contrlo : controlo 
uam : uma
exemmplo : exemplo
validadda : validada
aqualquer : qualquer
compreenção : compreensão
compnentes : componentes
arlém : além
respresentam : representam
prética : prática
outrs : outras
veirficados : verificados
dificíl : difícil
masrca : marca
sucessivvamente : ucessivamente
genero : género
oprigem : origem
génro : género
anaalisado : analisado
válidaas : válidas
nãao : não
tãao : tão
traansformaar : transformar
mãao : mão
saberiamos : aberíamos
substituíndo : ubstituindo
aasociadas : associadas
braqueiro : barqueiro
identico : idêntico
nãoa : não-a 
detrminada : determinada
abeviaturas : abreviaturas
dtio : dito
paravras : palavras
prvisíveis : pevisíveis
rdical : radical
outrso : outros
excluida : excluída
probabiliade : probabilidade
passivante : apassivante
uam : uma
guarda-sois : guarda-sóis
toamndo : tomando
desenvvolvimento : desenvolvimento
preeenchimento : preenchimento
protuguês : portugês
imposssível : impossível
constroi-se : constrói-se
milisegundos : milissegundos
resultdos : resultados
ctgorias : categorias
soubermso : oubermos
incluimos : incluímos
concluimos : concluímos
caracter : carácter
prorámos : procuramos
rsultados : resultados
pis : pois 
obtivémos : obtivemos
esperariamos : esperaríamos
constactar : constatar
romanso : romanos
detrminado : determinado
equilibrio : equilíbrio
bastave : bastava
re-escrever : reescrever
aparecerrem : aparecerem
possuimos : possuímos
rro : erro
igonrado : ignorado
limitaamos : limitamos
benificia : beneficia
fizémos : fizemos
mara : para
morfolópgico : morfológico
sre : er
aa : a
paalavroso : palavroso
aaos : aos
conpõem : compõem
eventuaalmente : eventualmente 
sequncialmente : equencialmente
genéricamente : genericamente
vaamos : vamos
dixer : dizer
aaplicação : aplicação
usaamos : usamos
aa : a
aao : ao
mutio : muito
aacrescentar : acrescentar
justifcar-se : justificar-se
maaior : maior
maaiúsculas : maiúsculas
operaçãao : operação
correctro : correcto
trigraama : trigrama
sugstões : ugestões
recorremos-nos : recorremo-nos
quaais : quais
entraamos : entramos
aa : a
substituida : ubstituída
verificaamos : verificamos
recursus : recursos
naão : não
implicitaamnte : implicitamente
caapítulo : capítulo
suaa : ua
daa : da
aplicaação : aplicação
funcionarlidade : funcionalidade
plataaformas : plataformas
nãao : não
aainda : ainda
úncio : único
anáalise : análise
vaai : vai
procuraamos : procuramos
usadno : usando
dosi : dois
apanhaar : apanhar
aabordagem : abordagem
rgras : regras
anáalise : análise
Marital : concluímos : concluimosMarrial
Nacionality : Nationality
Adress : Address
peryod : period
Engennering : Engineering
inteligence : intelligence
enphasis : emphasis
mophological : morphological
dictionnaries : dictionaries
chscking : checking
gramatic : grammatic
dictionnary : dictionary
abóboda : abóbada
absti-me : abstive-me
abstrato : abstracto
aceço : acesso
acelarar : acelerar
àcerca : acerca
acerção : asserção
acessabilidade : acessibilidade
aceza : acesa
acezo : aceso
acordãos : acórdãos
açoreano : açoriano
açossiar : associar
actris : actriz
adamastor : Adamastor
adeuzinho : adeusinho
Adotamos : Adoptamos
adotar : adoptar
adquirí-los : adquiri-los
aério : aéreo
aero-clube : aeroclube
ageitar : ajeitar
agonisar : agonizar
agradaveis : agradáveis
ajuisar : ajuizar
album : álbum
albuns : álbuns
alerjia : alergia
alfasema : alfazema
alforje : alforge
algasarra : algazarra
algerós : algeroz
algoses : algozes
alissiante : aliciante
alissiar : aliciar
alizar : alisar
alumeia : alumia
àmanhã : amanhã
âmbigua : ambígua
âmbiguidade : ambiguidade
amenisar : amenizar
analizador : analisador
analizar : analisar
análize : análise
ância : ânsia
ansestral : ancestral
ansestralidade : ancestralidade
ansiolitico : ansiolítico
ansiulítico : ansiolítico
antigùidade : antiguidade
aporado : apurado
aporar : apurar
aporteguesamento : aportuguesamento
aporteguesar : aportuguesar
aquem : aquém
àquem : aquém
aquí : aqui
arborisar : arborizar
aridês : aridez
armazem : armazém
armazens : armazéns
arquiteto : arquitecto
Arquitetura : Arquitectura
arrange : arranje
arrangei : arranjei
arrangemos : arranjemos
arranges : arranjes
arrazado : arrasado
arrazar : arrasar
arrea : arreia
arregassado : arregaçado
arregassar : arregaçar
artfício : artifício
asáfama : azáfama
ascenção : ascensão
aseite : azeite
asenha : azenha
asia : azia
asimute : azímute
assás : assaz
asseço : acesso
assersão : asserção
assesso : acesso
Assessoria : Acessoria
assossiar : associar
assúcar : açúcar
assucena : açucena
atabalhuar : atabalhoar
atarrachar : atarraxar
aterrorisar : aterrorizar
atléctico : atlético
atraiçôe : atraiçoe
atraissoar : atraiçoar
atraiste : atraíste
atraves : através
atravez : através
atraz : atrás
atrazar : atrasar
atrazo : atraso
atribuia : atribuía
atribuiam : atribuíam
atribuiamos : atribuíamos
atribuimos : atribuímos
atribuiram : atribuíram
atribuírei : atribuirei
atribuirem : atribuírem
atribuíremos : atribuiremos
atribuitivo : atributivo
atriz : actriz
atual : actual
audio-visual : audiovisual
Autoestradas : Auto-estradas
automatisação : automatização
autorisar : autorizar
autosuspensão : auto-suspensão
autosuspenso : auto-suspenso
autosustentação : auto-sustentação
averigue : averigúe
avizado : avisado
avizar : avisar
avizo : aviso
azíago : aziago
azuleijo : azulejo
azuleijos : azulejos
babozeira : baboseira
babuseira : baboseira
bacharlato : bacharelato
bactriana : bacteriana
badagaio : vadagaio
balisa : baliza
banderilha : bandarilha
baptisar : baptizar
baqueteriano : bacteriano
barcassa : barcaça
barróco : barroco
barrócos : barrocos
basar : bazar
basófia : bazófia
batizar : baptizar
baze : base
bébe : bebé
bébé : bebé
belesa : beleza
bemequer : bem-me-quer
Bemfica : Benfica
benção : bênção
benificiações : beneficiações
benificiar : beneficiar
benquerer : bem-querer
benvindo : bem-vindo
berbulha : borbulha
bisarro : bizarro
bisexto : bissexto
bisexual : bissexual
bisexualidade : bissexualidade
bissectris : bissectriz
bissessual : bissexual
bissetriz : bissectriz
bocage : Bocage
boia : bóia
boiam : bóiam
boie : bóie
boiem : bóiem
boio : bóio
bolir : bulir
bonus : bónus
borbolha : borbulha
borbolhar : borbulhar
braza : brasa
brazil : Brasil
bregeiro : brejeiro
briza : brisa
bruxelas : Bruxelas
bujiar : bugiar
burborinho : burburinho
busina : buzina
cafeina : cafeína
cafeseiro : cafezeiro
caichilho : caixilho
caiem : caem
caimbras : cãibras
caímbras : cãibras
caíndo : caindo
caír : cair
caír-lhe : cair-lhe
caira : caíra
caírá : cairá
cairam : caíram
caírão : cairão
caírás : cairás
caírdes : cairdes
cairem : caírem
caíremos : cairemos
caires : caíres
cairmos : caírmos
caírmos : cairmos
calcáreo : calcário
cális : cálice
calsar : calçar
calvice : calvície
campaínha : campainha
campião : campeão
cançar : cansar
cançaso : cansaço
cançasso : cansaço
cansão : canção
cãosinho : cãozinho
cãozínho : cãozinho
capás : capaz
captivo : cativo
carácteres : caracteres
carangueijo : caranguejo
carateres : caracteres
carcassa : carcaça
cardio-vascular : cardiovascular
Carissimos : Caríssimos
carlos : Carlos
carmos : Carmos
carrocel : carrossel
carroucel : carrossel
cartomância : cartomancia
cascável : cascavel
cassarola : caçarola
catalizar : catalisar
catálize : catálise
catura : captura
causadíaco : causídico
cêra : cera
cérca : cerca
cêrca : cerca
cerimônia : cerimónia
cerralheiro : erralheiro
certâme : certame
certesa : certeza
cetásseo : cetáceo
ceu : céu
cezariana : cesariana
chaile : xaile
chale : xale
chapeu : chapéu
chasso : chaço
chatiar : chatear
chatiava : chateava
chatisse : chatice
cheché : xexé
chéché : xexé
cheinho : cheiinho
cheínho : cheiinho
cheíssimo : cheiíssimo
chícara : xícara
chuxa : chucha
cicatrisar : cicatrizar
cicratisar : cicatrizar
cintaxe : intaxe
ciume : ciúme
claresa : clareza
classismo : classicismo
cobissa : cobiça
coca-cola : Coca-cola
côdia : côdea
colectivisação : colectivização
coletivização : colectivização
colijir : coligir
colinária : culinária
colizeu : coliseu
combóio : comboio
comperativa : cooperativa
complementariedade : complementaridade
compreenção : compreensão
comprendeu : compreendeu
compurscar : conspurcar
comumente : comummente
concenso : consenso
concluia : concluía
concluira : concluíra
concluírmos : concluirmos
concluíu : concluiu
condizessem : condissessem
condú-la : condu-la
condus : conduz
condusir : conduzir
conecsão : conexão
conexionados : conexos
côngegue : cônjuge
cônjuga : cônjuge
cônjugue : cônjuge
conscencioso : consciencioso
consciencia : consciência
consegui-se : conseguisse
conserne : concerne
consernir : concernir
consider : considere
consinteis : consintais
consomas : consumas
consomir : consumir
consporcar : conspurcar
Constacto : Constato
constitue : constitui
constituia : constituía
constituíndo : constituindo
constituira : constituíra
constituitivo : constitutivo
constroiem : constroem
construi : construí
construia : construía
contêem : contêm
contens : conténs
conti-me : contive-me
contra-prova : contraprova
contracto : contrato
contractos : contratos
contrai-lo : contraí-lo
contraiem : contraem
contrassenso : contra-senso
contribuínte : contribuinte
contribuitivo : contributivo
contricção : contrição
control : controlo
contrôle : controlo
convem : convém
convens : convéns
convir : convier
cór : cor
côr : cor
corajem : coragem
cordeal : cordial
córes : cores
côres : cores
coroneis : coronéis
corrícolo : currículo
corrículo : currículo
corropio : corrupio
cortezia : cortesia
coscovilheiras : coscuvilheiras
coscovilhice : coscuvilhice
crâneo : crânio
creação : criação
creador : criador
crear : criar
creatura : criatura
creem : crêem
crêm : crêem
creoulo : crioulo
cristamente : cristãmente
cristanmente : cristãmente
crusador : cruzador
crusar : cruzar
cruseiro : cruzeiro
cubiça : cobiça
cubiçar : cobiçar
culidir : colidir
culigir : coligir
culina : colina
culisão : colisão
culiseu : coliseu
currícolo : currículo
curropio : corrupio
custume : costume
da-me : dá-me
damos-nos : damo-nos
dansar : dançar
darnos : dar-nos
decaiem : decaem
defenido : definido
defeza : defesa
degecção : dejecção
degejuar : desjejuar
degejum : desjejum
degladiar : digladiar
deixásse-mos : deixássemos
dejeção : dejecção
dejetos : dejectos
deleciosas : deliciosas
delegenciar : diligenciar
deligencia : diligência
dêm : dêem
deminuto : diminuto
démos : demos
depôr : depor
depos : depôs
depoz : depôs
depremido : deprimido
depremir : deprimir
derruido : derruído
desaçocego : desassossego
desacôrdo : desacordo
desassocego : desassossego
desassossiar : desassociar
descançar : descansar
descanço : descanso
descelar : desselar
descontração : descontracção
descubri : descobri
desenchabido : desenxabido
desenteria : disenteria
desfasajem : desfasagem
desfazagem : desfasagem
desfazer-te-ia : desfar-te-ia
desfeicho : desfecho
desfês : desfez
deshabitar : desabitar
desharmonia : desarmonia
deshonestidade : desonestidade
deshonesto : desonesto
deshonra : desonra
desiquelíbrio : desequilíbrio
desiquilíbrio : desequilíbrio
deslisar : deslizar
deslise : deslize
desmoralisar : desmoralizar
desoito : dezoito
despachanta : despachante
despedí-la : despedi-la
despêndio : dispêndio
despendioso : dispendioso
despeza : despesa
desprézo : desprezo
desprêzo : desprezo
desseminado : disseminado
desseminar : disseminar
desser : descer
dessimulação : dissimulação
dessimulado : dissimulado
dessimular : dissimular
destinta : distinta
destroi : destrói
destruido : destruído
deteu : deteve
dexer : descer
dezacordo : desacordo
dezaçossiar : desassociar
dezalinho : desalinho
dezentendimento : desentendimento
dezespero : desespero
dezóito : dezoito
dí-lo : di-lo
dição : dicção
diccionário : dicionário
dignatário : dignitário
dignitáreo : dignitário
dijerir : digerir
dijestão : digestão
dijiro : digiro
diminuiram : diminuíram
diminuitivo : diminutivo
dinossaurios : dinossáurios
diónisicas : dionisíacas
dirijisse : dirigisse
dis : diz
discreção : discrição
discuções : discussões
diser : dizer
disfruta-se : desfruta-se
disfrutado : desfrutado
disfrutador : desfrutador
disfrutar : desfrutar
disfrute : desfrute
dispar : díspar
dispendedor : despendedor
dispender : despender
dispendido : despendido
disposer : dispuser
dissere : disser
dissereis : disséreis
dissuador : dissuasor
dissuazivo : dissuasivo
dissuazor : dissuasor
distenção : distensão
distrai-lo : distraí-lo
distraiem : distraem
distraír : distrair
distribui-lo : distribuí-lo
districto : distrito
divêrgencia : divergência
dizer-se-á : dir-se-á
dizer-se-ão : dir-se-ão
dizer-te-ia : dir-te-ia
dôo : doo
eboliente : ebuliente
efabolação : efabulação
efabolar : efabular
éfebo : efebo
efeverescência : efervescência
efeverscência : efervescência
egoismo : egoísmo
egurgitar : ingurgitar
egurjitar : ingurgitar
eide : hei-de
electro-encefalograma : electroencefalograma
elejer : eleger
eletrotecnica : electrotécnica
élite : elite
elítico : elíptico
elocidar : elucidar
embaixadora : embaixatriz
embevedar : embebedar
embevedava : embebedava
embriaguês : embriaguez
embucadura : embocadura
embulado : embolado
embular : embolar
embuscada : emboscada
emição : emissão
emiçora : emissora
emitação : imitação
emitar : imitar
emmagrecer : emagrecer
emmoldurar : emoldurar
empreza : empresa
encaiches : encaixos
encaxes : encaixes
encertar : encetar
enchada : enxada
enchado : inchado
enchar : inchar
enchovalhada : enxovalhada
enchovalhar : enxovalhar
enchugar : enxugar
enchuto : enxuto
encómodo : incómodo
encomudo : incómodo
encorage : encoraje
enesqueciveis : inesquecíveis
enesquecivel : inesquecível
ênfa-se : ênfase
engorjitar : engorgitar
engrachador : engraxador
engrachar : engraxar
engurgitar : engorgitar
enluada : aluada
enovador : inovador
entôo : entoo
entráva-mos : entrávamos
entreteste-te : entretiveste-te
entreteu-se : entreteve-se
entreti-me : entretive-me
entretiam : entretinham
entumescer : intumescer
entumescia : intumescia
entupes : entopes
enviezado : enviesado
enxagoar : enxaguar
equisema : eczema
erbanário : ervanário
erbanário : herbanário
ereis : éreis
eremita : ermita
erimita : ermita
eritrocitos : eritrócitos
erodito : erudito
erpes : herpes
érro : erro
êrro : erro
erúdito : erudito
esbóço : esboço
esbôço : esboço
esclamar : exclamar
esclamou : exclamou
esclusivo : exclusivo
esdrúxola : esdrúxula
esfero-gráfica : esferográfica
esforsam : esforçam
esgaseado : esgazeado
esímio : exímio
esmaltear : esmaltar
espaguete : esparguete
especime : espécime
especimens : espécimes
espectativas : expectativas
espertesa : esperteza
espêsso : espesso
espetativa : expectativa
espicassar : espicaçar
espontaniedade : espontaneidade
espontânio : espontâneo
espontânio : espontâneo
espôsa : esposa
espôso : esposo
espurgar : expurgar
esquesitisse : esquisitice
esquesito : esquisito
establecer : estabelecer
estenuante : extenuante
estepor : estupor
esteporado : estuporado
estipidês : estupidez
estómago : estômago
estorsão : extorsão
estórvo : estorvo
estôrvo : estorvo
estranhesa : estranheza
estranjeirismo : estrangeirismo
estranjeiro : estrangeiro
estratejista : estrategista
estravagâncias : extravagâncias
estravasar : extravasar
estraviar : extraviar
estreitesa : estreiteza
estrelato : estrelado
estrépido : estrépito
estrovar : estorvar
estructurado : estruturado
estupurado : estuporado
esvasiar : esvaziar
etério : etéreo
eutanázia : eutanásia
evitae : evitai
excepsão : excepção
exceto : excepto
exdrúxula : esdrúxula
exdrúxulas : esdrúxulas
eximio : exímio
exitar : hesitar
exito : hesito
expecialmente : especialmente
expesso : espesso
explêndido : esplêndido
explendor : esplendor
expontâneo : espontâneo
Extender : Estender
extendidos : estendidas
extorção : extorsão
extravazar : extravasar
fabolar : fabular
faboloso : fabuloso
fac-simile : fac-símile
fachina : faxina
faisca : faísca
faíscar : faiscar
falariam-nos : falar-nos-iam
falásteis : falastes
farça : farsa
faría-mos : faríamos
farramenta : ferramenta
faser : fazer
fazê-lo-ias : fá-lo-ias
fazer-se-á : far-se-á
fazer-se-ão : far-se-ão
femenilidade : feminilidade
fêmur : fémur
femural : femoral
ferrúgem : ferrugem
ferrujem : ferrugem
fertilisar : fertilizar
fí-lo : fi-lo
fiabelidade : fiabilidade
fiablidade : fiabilidade
finaflor : fina-flor
fiqueim : fiquem
fiscalisação : fiscalização
fiscalisar : fiscalizar
físicos-químicos : físico-químicos
fisilogia : fisiologia
fiz-lo : fi-lo
fizes-te : fizeste
fluídez : fluidez
flúidez : fluidez
fluidico : fluídico
fluído : fluido
foguête : foguete
fôr : for
fôra : fora
fôrça : força
fôrem : forem
formusura : formosura
fôro : foro
fortivo : furtivo
forum : fórum
foruns : fóruns
fosforecente : fosforescente
fransido : franzido
fransir : franzir
fraquesa : fraqueza
frenezi : frenesi
frenezim : frenesim
freza : fresa
frezadora : fresadora
friza : frisa
frizar : frisar
frizo : friso
frustatório : frustratório
fugire : fugir
furmosura : formosura
furmusura : formosura
furtuito : fortuito
furtunas : fortunas
gabardine : gabardina
galinácio : galináceo
gasela : gazela
gasua : gazua
gazeado : gaseado
geito : jeito
geitosa : jeitosa
gérme : germe
germen : gérmen
gerundio : gerúndio
giboia : jibóia
gibóia : jibóia
gibóia : jibóia
gimnásio : ginásio
giradiscos : gira-discos
gis : giz
gordoroso : gorduroso
gorgeta : gorjeta
goso : gozo
gózo : gozo
gracil : grácil
graínha : grainha
grangear : granjear
gratuíto : gratuito
gravidês : gravidez
gravideses : gravidezes
GRECIA : GRÉCIA
gromete : grumete
grumête : grumete
gurdoroso : gorduroso
habitoo-se : habituou-se
hainda : ainda
helimotor : heliomotor
helioporto : heliporto
hemorregia : hemorragia
heriditariedade : hereditariedade
hervanário : ervanário
hervanário : herbanário
heterogêneo : heterogéneo
heterogénias : heterogéneas
heterogénio : heterogéneo
hexitar : hesitar
hêxito : êxito
hidrogéneo : hidrogénio
hidrogênio : hidrogénio
hieroglifos : hieróglifos
higiéne : higiene
hijiene : higiene
hilariedade : hilaridade
hiper-sensibilidade : hipersensibilidade
hipnotisação : hipnotização
hipnotisado : hipnotizado
hipnotisador : hipnotizador
hipnotisar : hipnotizar
hipnoze : hipnose
hipodromo : hipódromo
hireditário : hereditário
holandêses : holandeses
homo-sexualidade : homossexualidade
homogêneo : homogéneo
homogénio : homogéneo
homogenizar : homogeneizar
horisonte : horizonte
hóstil : hostil
hovesse : houvesse
íam : iam
iamos : íamos
ías : ias
íbero : ibero
idealogia : ideologia
idenpotente : idempotente
identica : idêntica
idoniedade : idoneidade
ieis : íeis
igiene : higiene
ilhoses : ilhós
ilucidar : elucidar
imcompleto : incompleto
imissão : emissão
imperadora : imperatriz
impertigado : empertigado
implozão : implosão
implusão : implosão
impolsionar : impulsionar
impúdico : impudico
impulsiunar : impulsionar
imundice : imundície
inabeis : inábeis
ináudito : inaudito
incerção : inserção
incerir : inserir
incluia : incluía
incluiam : incluíam
incluido : incluído
incluíndo : incluindo
incluiram : incluíram
incluírão : incluirão
incluírdes : incluirdes
incluiría : incluiria
incluíria : incluiria
incluírmos : incluirmos
incluisse : incluísse
incluíu : incluiu
inclusivé : inclusive
inconpleto : incompleto
incorajar : encorajar
incrostar : incrustar
incrostrada : incrustada
indivídua : indivíduo
infraestrutura : infra-estrutura
Infraestrutura : Infra-estrutura
infraestruturas : infra-estruturas
ingecções : injecções
inglêses : ingleses
inglezice : inglesice
inglezisse : inglesice
inhábil : inábil
ínicio : início
injeção : injecção
insersão : inserção
insistencia : insistência
inssondaveis : insondáveis
inssurreição : insurreição
insurreissão : insurreição
inter-comunicador : intercomunicador
inter-institucionais : interinstitucionais
inter-sexual : intersexual
inter-sexualidade : intersexualidade
interésses : interesses
intergeição : interjeição
interropção : interrupção
intersecsual : intersexual
intervia : intervinha
intervido : intervindo
intervisse : interviesse
interviu : interveio
intransijência : intransigência
intransijente : intransigente
intranzijente : intransigente
intrepor : interpor
intrevido : intervindo
intrevisto : entrevisto
intuia : intuía
inxugar : enxugar
inxuto : enxuto
ir-mos : irmos
irrascível : irascível
items : itens
itenerário : itinerário
jiboia : jibóia
joia : jóia
jóvem : jovem
jóvens : jovens
joventude : juventude
juíso : juízo
juizes : juízes
juizo : juízo
junho : Junho
júniores : juniores
juri : júri
Kg : kg
kilo : quilo
kilómetro : quilómetro
Km : km
ladiar : ladear
lage : laje
lagem : lajem
lambusado : lambuzado
lampeão : lampião
lapis : lápis
largato : lagarto
Latinoamericano : Latino-americano
lé-la : lê-la
lesíria : lezíria
letivo : lectivo
leucocitos : leucócitos
levesa : leveza
liçenças : licenças
licensas : licenças
licensiado : licenciado
liche : lixe
ligeiresa : ligeireza
lijeireza : ligeireza
lijeiro : ligeiro
limpesa : limpeza
linguísta : linguista
linguistica : linguística
linxado : linchado
lógicamente : logicamente
logotipo : logótipo
logutipo : logótipo
lúmbago : lumbago
lunbago : lumbago
lúpolo : lúpulo
lusitaneidade : lusitanidade
lusitaniedade : lusitanidade
maçagista : massagista
macissos : maciços
madre-silva : madressilva
magestoso : majestoso
magresa : magreza
mágua : mágoa
mal-casado : malcasado
mal-cheiroso : malcheiroso
mal-contente : malcontente
mal-criado : malcriado
mal-feito : malfeito
mal-me-quer : malmequer
mal-nascido : malnascido
mal-visto : malvisto
malavisado : mal-avisado
malencarado : mal-encarado
malentendidos : mal-entendidos
malidicências : maledicências
mamarraxo : mamarracho
manganês : manganés
mangerico : manjerico
mantem-se : mantém-se
manti-me : mantive-me
Mariza : Marisa
marmórico : marmóreo
marmório : marmóreo
martirisar : martirizar
matris : matriz
mausoleu : mausoléu
mecher : mexer
mecher-lhe : mexer-lhe
médica-cirúrgica : médico-cirúrgica
médicos-cirúrgicos : médico-cirúrgicos
mediocre : medíocre
medium : médium
mediuns : médiuns
memorandu : memorando
menistro : ministro
mensão : menção
mensionar : mencionar
mercieiro : merceeiro
meretíssimo : meritíssimo
mesericórdia : misericórdia
méta : meta
mêta : meta
meteriologia : meteorologia
métro : metro
microinformática : micro-informática
minímo : mínimo
minissaia : mini-saia
miradoro : miradouro
miuda : miúda
miudo : miúdo
mixto : misto
moiem : moem
moínho : moinho
môlhos : molhos
monocórdia : monocórdica
monotunia : monotonia
môo : moo
mormura : murmura
mormurar : murmurar
mostrão : mostram
mostreios : mostrei-os
muí : moí
mulhado : molhado
multim-media : multimédia
municioso : minucioso
munotonia : monotonia
muribundo : moribundo
mussulmano : muçulmano
mustrar : mostrar
neo-latino : neolatino
neuro-psíquico : neuropsíquico
nitrogéneo : nitrogénio
nitrogênio : nitrogénio
nobresa : nobreza
norueste : noroeste
notabilização : notabilidade
nóvel : novel
nuno : Nuno
núvem : nuvem
obceção : obsessão
obcessão : obsessão
obcessivo : obsessivo
obececar : obcecar
obetenho : obtenho
obezidade : obesidade
objéctivo : objectivo
Objetos : Objectos
obrigatoriadade : obrigatoriedade
obsecação : obcecação
obsecado : obcecado
obseção : obsessão
obsecar : obcecar
obsecassão : obcecação
obseletos : obsoletos
obsequia : obsequeia
obsuletos : obsoletos
obzequiar : obsequiar
ôca : oca
ôco : oco
ocurrer : ocorrer
odia : odeia
odie : odeie
odiem : odeiem
ogemose : osmose
olfativo : olfactivo
oliar : olear
ólio : óleo
omiço : omisso
onanimista : unanimista
openião : opinião
ópinar : opinar
opôr : opor
organisação : organização
organisar : organizar
orgãos : órgãos
orígem : origem
ostrassismo : ostracismo
ótimo : óptimo
ourina : urina
ourinar : urinar
ourinol : urinol
outubro : Outubro
ouví-lo : ouvi-lo
oxilações : oscilações
rá : p'prà
paciênsia : paciência
pagem : pajem
paizagem : paisagem
pandega : pândega
pândigo : pândego
paposseco : papo-seco
para-choques : pára-choques
parachoques : pára-choques
paralização : paralisação
paralizar : paralisar
paraquedas : pára-quedas
pararraios : pára-raios
parteleira : prateleira
parvoice : parvoíce
passeo : passeio
passiar : passear
passiei : passeei
passiemos : passeemos
passiência : paciência
páteo : pátio
patrimônio : património
pchisbeque : pechisbeque
pêcego : pêssego
pêche : peixe
pecoária : pecuária
pedí-la-ei : pedi-la-ei
péga : pega
pêga : pega
pègada : pegada
peiche : peixe
penalisante : penalizante
pendoricalho : penduricalho
penduresa : pendureza
penecilina : penicilina
penincilina : penicilina
pequenês : pequenez
pera : pêra
pêras : peras
perceisamente : precisamente
perceito : preceito
perceptorado : preceptorado
perclaro : preclaro
perconizar : preconizar
percuária : pecuária
pérda : perda
perdominar : predominar
perduar : perdoar
perduou : perdoou
perferivel : preferível
periodo : período
perjuízo : prejuízo
permissa : premissa
perpúcio : prepúcio
persagiam : pressagiam
persentido : pressentido
perspetiva : perspectiva
perstações : prestações
persuazão : persuasão
pertensão : pretensão
perverção : perversão
pesarozo : pesaroso
pescôço : pescoço
pêso : peso
pesso : peço
petisa : petiza
petrólio : petróleo
pêxe : peixe
pezadelo : pesadelo
pezar : pesar
pezaroso : pesaroso
pictoresco : pinturesco
pilôto : piloto
pilótos : pilotos
pintoresco : pinturesco
pique-nique : piquenique
piquena : pequena
pirezinho : piresinho
piroupo : piropo
pituresco : pitoresco
piugada : peugada
platéia : plateia
pleiade : plêiade
po-lo : pô-lo
pobresa : pobreza
pobresinho : pobrezinho
poco : pouco
pôco : pouco
podera : pudera
poderam : puderam
poderia-me : poder-me-ia
podessemos : pudéssemos
poem : põem
pôem : põem
poéticos-literários : poético-literários
polas : pulas
poligâmia : poligamia
politecnico : politécnico
ponteagudo : pontiagudo
porlongar : prolongar
porlongue : prolongue
portecção : protecção
portugues : português
portuguêsa : portuguesa
portuguêsmente : portuguesmente
porvidência : providência
pos : pôs
poseres : puseres
posescolar : pós-escolar
posesses : pusesses
posglaciário : pós-glaciário
posoperatório : pós-operatório
possiblidade : possibilidade
possiveis : possíveis
possivel : possível
potuguezismo : portuguesismo
pôz-se : pôs-se
pozes : poses
pozésseis : pusésseis
pozéssemos : puséssemos
pozinhos : posinhos
prá : prà
precalço : percalço
preceitoar : preceituar
preceverança : perseverança
precizar : precisar
preconisar : preconizar
predidos : perdidos
predumínio : predomínio
prefazer : perfazer
prejuíso : prejuízo
prejuizo : prejuízo
premear : premiar
prémeo : prémio
premissão : permissão
prencípio : princípio
prenhês : prenhez
preplexidade : perplexidade
preplexo : perplexo
prescrutação : perscrutação
prescrutador : perscrutador
prespectiva : perspectiva
pressajiar : pressagiar
presserverar : perseverar
presseverança : perseverança
prestassões : prestações
presuasão : persuasão
pretenção : pretensão
pretencioso : pretensioso
pretesto : pretexto
preversão : perversão
preversidade : perversidade
preverso : perverso
preverter : perverter
previlégio : privilégio
prezumido : presumido
prezunção : presunção
primasia : primazia
príncepe : príncipe
principe : príncipe
priveligiado : privilegiado
probolemas : problemas
procheneta : proxeneta
productos : produtos
profundesa : profundeza
progreção : progressão
projeto : projecto
projetos : projectos
promenor : pormenor
promenores : pormenores
propragação : propagação
propridade : propriedade
prorogação : prorrogação
prorogado : prorrogado
prorogar : prorrogar
prorrugar : prorrogar
prossessador : processador
protextar : protestar
protexto : protesto
prototipo : protótipo
provalvelmente : provavelmente
proventura : porventura
provéssemos : provêssemos
providencià-lo : providenciá-lo
PROVINIENTE : PROVENIENTE
provinientes : provenientes
pruibido : proibido
psico-social : psicossocial
psico-somático : psicossomático
pú-lo : pu-lo
pû-la : pu-la
puderá : poderá
pulido : polido
pulimos : polimos
pulmunar : pulmonar
puresa : pureza
puz : pus
puzemos : pusemos
puzera : pusera
puzeram : puseram
puzeras : puseras
puzeres : puseres
puzermos : pusermos
puzesse : pusesse
puzesses : pusesses
puzeste : puseste
pxisbeque : pechisbeque
quartas-feiras : Quartas-feiras
queiremos : queiramos
quer-o : quere-o
quere : quer
quere-me : quer-me
quere-se : quer-se
querêmo-lo : queremo-lo
quí-lo : qui-lo
quiça : quiçá
quís : quis
quis-lo : qui-lo
quisere : quiser
quisésteis : quisestes
quissá : quiçá
quiz : quis
quizemos : quisemos
quizer : quiser
quizera : quisera
quizeram : quiseram
quizéramos : quiséramos
quizeras : quiseras
quizerdes : quiserdes
quizerem : quiserem
quizeres : quiseres
quizesse : quisesse
quizessem : quisessem
quizeste : quiseste
quizésteis : quisestes
rabuge : rabuje
rabujento : rabugento
rabujice : rabugice
rabuscada : rebuscada
rádio-amador : radioamador
raínha : rainha
raíz : raiz
rangir : ranger
rapasinho : rapazinho
ràpidamente : rapidamente
rasia : razia
raza : rasa
razo : raso
reajir : reagir
recaiem : recaem
recentimento : ressentimento
recentir : ressentir
recepiente : recipiente
rectroactivas : retroactivas
rectroactivo : retroactivo
rectroactivos : retroactivos
redatorial : redactorial
redijir : redigir
redol : Redol
reeinstalar : reinstalar
refelexão : reflexão
refer-se : refere-se
referirnos-emos : referir-nos-emos
refletir : reflectir
regeição : rejeição
regeitar : rejeitar
rêgo : rego
regorgitar : regurgitar
reincarnar : reencarnar
reinvidicações : reivindicações
reinvidicar : reivindicar
rejeissão : rejeição
rejisto : registo
rejovenescer : rejuvenescer
rejovenescimento : rejuvenescimento
relacção : relação
relaccionados : relacionados
remedia : remedeia
remedio : remedeio
repucho : repuxo
repurtório : repertório
requere : requer
requere-se : requer-se
requesitos : requisitos
resgistados : registados
resplandescência : resplandecência
resplandescente : resplandecente
ressaiem : ressaem
ressurjir : ressurgir
ressurreissão : ressurreição
réstea : réstia
restricto : restrito
restrinjir : restringir
reteu : reteve
reto : recto
reunes : reúnes
reúnir : reunir
reuno : reúno
rezina : resina
riagir : reagir
ridícolo : ridículo
ringi : rangi
ringido : rangido
riquesa : riqueza
robéula : rubéola
rolissa : roliça
rolisso : roliço
roptura : ruptura
rouxinois : rouxinóis
roxinol : rouxinol
rúbrica : rubrica
ruí : roí
ruido : ruído
ruimente : ruimmente
sacrilegadamente : acrilegamente
saida : aída
saiem : aem
saimos : aímos
saíndo : aindo
saír : air
saira : aíra
saírá : airá
sairam : aíram
saírão : airão
saírás : airás
saírdes : airdes
sairem : aírem
saíremos : airemos
saires : aíres
saírmos : airmos
saíu : aiu
salganhada : algalhada
saliba : aliva
salvaguadar : alvaguardar
saracotiar : aracotear
sàudade : audade
saude : aúde
sear : cear
secrestar : equestrar
secresto : equestro
secretaría : ecretaria
segnificado : ignificado
seia : ceia
Seleção : Selecção
selecionar : eleccionar
selinidade : enilidade
selvajamente : elvaticamente
selvajem : elvagem
selvajeria : elvageria
semi-anual : emianual
semi-cerrado : emicerrado
semi-circular : emicircular
semi-eixo : emieixo
semi-oficioso : emioficioso
semi-vogal : emivogal
semihomem : emi-homem
semiinconsciente : emi-inconsciente
semirrei : emi-rei
semissábio : emi-sábio
semisselvagem : emi-selvagem
sençura : censura
sensura : censura
sensuras : censuras
sera : cera
sêra : cera
seram : erão
sereal : cereal
seríam : eriam
serimonioso : cerimonioso
serzir : cerzir
setim : cetim
setor : ector
setores : ectores
Sexta-Feira : Sexta-feira
sextas-feiras : Sextas-feiras
siflítico : ifilítico
simbolo : ímbolo
sinosite : inusite
sintasse : intaxe
sintático : intáctico
sintonisar : intonizar
sinuzite : inusite
sôbe : oube
sobrecelente : obresselente
sobrehumano : obre-humano
sobridade : obriedade
socegado : ossegado
socegar : ossegar
socego : ossego
sociadade : ociedade
soçubrar : oçobrar
socumbir : ucumbir
sodeste : udeste
sodueste : udoeste
sòmente : omente
sonâmbolo : onâmbulo
sorjo : urjo
sorrizinho : orrisinho
sorvéte : orvete
sosinho : ozinho
sossobrar : oçobrar
sotãos : ótãos
sovieticos : oviéticos
sòzinho : ozinho
sub-delegado : ubdelegado
sub-grupo : ubgrupo
Sub-grupo : Subgrupo
sub-solos : ubsolos
subesserviência : ubserviência
subibliotecário : ub-bibliotecário
subito : úbito
subrepticiamente : ub-repticiamente
subrepticio : ub-reptício
substituia : ubstituía
substituitivo : ubstitutivo
substituíu : ubstituiu
substracto : ubstrato
suçobrar : oçobrar
sujerir : ugerir
sujestão : ugestão
sunambulismo : onambulismo
súper-homem : uper-homem
superhomem : uper-homem
suprassumo : upra-sumo
supreção : upressão
suprestição : uperstição
supresticioso : upersticioso
surjir : urgir
surprêsa : urpresa
surpreza : urpresa
surrapa : zurrapa
survete : orvete
suspenção : uspensão
susseder : uceder
taboleiro : tabuleiro
talvés : talvez
tambem : também
tartante : tratante
tática : táctica
tático : táctico
teem : têm
tele-guiado : teleguiado
televizivo : televisivo
tém : tem
tem-o : tem-no
tênue : ténue
tênues : ténues
terebentina : terebintina
terjeitos : trejeitos
terramoto : terremoto
terraplanagem : terraplenagem
terraplanar : terraplenar
terraqueo : terráqueo
terráquio : terráqueo
têsteis : têxteis
tetos : tectos
teurapêutico : terapêutico
texteis : têxteis
téxteis : têxteis
tijela : tigela
toráxico : torácico
torcícolo : torcicolo
torsão : torção
torser : torcer
torsida : torcida
torsido : torcido
tôrso : torso
totém : totem
totens : tótemes
toxico : tóxico
tragectória : trajectória
traiem : traem
trajédia : tragédia
trajeto : trajecto
trajetória : trajectória
trájico : trágico
tranquilisador : tranquilizador
tranquilisante : tranquilizante
trânsido : transido
transmetir : transmitir
transmição : transmissão
transmitente : transmissor
tranze : transe
tranzido : transido
traser : trazer
trazê-lo-ei : trá-lo-ei
trazê-lo-ia : trá-lo-ia
trazeira : traseira
trazeiro : traseiro
trazer-nos-ia : trar-nos-ia
trazer-se-á : trar-se-á
trazer-se-ão : trar-se-ão
tregeitos : trejeitos
tres : três
trez : três
tri-campeão : tricampeão
tricampiã : tricampeã
trilingue : trilíngue
tristesa : tristeza
trôco : troco
trousse : trouxe
troussestes : trouxestes
tunel : túnel
turcícolo : torcicolo
ultra-violeta : ultravioleta
úmido : húmido
uníssuno : uníssono
urano : urânio
utilisar : utilizar
utlizadores : utilizadores
vácum : vacum
vagãos : vagões
vasio : vazio
vé : vê
veiculo : veículo
veinculado : veiculado
vém : vem
vérbo : verbo
vêrbo : verbo
veredito : veredicto
veriação : vereação
veriador : vereador
vertígem : vertigem
vertígens : vertigens
veses : vezes
veu : véu
viésteis : viestes
vintem : vintém
vírgem : virgem
visinhança : vizinhança
visinho : vizinho
viuva : viúva
viuvês : viuvez
viúvez : viuvez
viuvo : viúvo
vivaço : vivaz
vivasso : vivaz
vizão : visão
vizar : visar
vizita : visita
vizitante : visitante
vizível : visível
vizualisar : visualizar
vizualizar : visualizar
vocemessê : vossemecê
voô : voou
vôo : voo
voses : vozes
vossemessê : vossemecê
vozeria : vozearia
vuô : voou
vuou : voou
xadresista : xadrezista
xal : xale
xalupa : chalupa
xávena : chávena
xéxé : xexé
xixi : chichi
xucha : chucha
xuxa : chucha
zenite : zénite
zig-zag : ziguezague
á : à
àrvore : árvore
acessas : acesas
actividadees : actividades
Administarção : Administração
Agosot : Agosto
algém : alguém
algorimto : algoritmo
amplamante : amplamente
aolgoritmos : algoritmos
aproxiamção : aproximação
arrajemos : arranjemos
avivizinham : avizinham
Barsil : Brasil
Bibliteca : Biblioteca
Bilioteca : Biblioteca
bolachinas : bolachinhas
brincadira : brincadeira
Camarados : Camaradas
candiadatos : candidatos
candiadaturas : candidaturas
candiadturas : candidaturas
caracteriscas : características
cedererem : cederem
Chesfes : Chefes
cinetificas : científicas
cobe : coube
comecâ : começa
computadres : computadores
comtempla : contempla
conguir : conseguir
constitudo : constituído
Contacos : Contactos
contrbuir : contribuir
contrpartida : contrapartida
contunar : continuar
contunar : continuar
correpondencia : correspondência
corres-pondência : correspondência
correspondecia : correspondência
correspondenccia : correspondência
cultuarais : culturais
demaais : demais
demonstarções : demonstrações
desenvimento : desenvolvimento
desenvovimento : desenvolvimento
desulpem : desculpem
dificukdades : dificuldades
diger : dizer
Direccção : Direcção
discusão : discussão
disses : disse
divlugue : divulgue
divugar : divulgar
domnos : donos
doutirado : doutorado
dsenvolvimento : desenvolvimento
eatarem : estarem
econtra : encontra
ecosistemas : ecossistemas
eferendo : referendo
Efificio : Edifício
elegação : delegação
emnos : menos
enconbtra : encontra
ENCONTA-SE : ENCONTRA-SE
ENCONTAM-SE : ENCONTRAM-SE
encontar : encontrar
Epediente : Expediente
escever : escrever
espirrito : espírito
esssa : essa
establecer : estabelecer
estajam : estejam
estass : estas
exeplares : exemplares
existêmcia : existência
exitencia : existência
experiancia : experiência
Extrordinaria : Extraordinária
favoráaveis : favoráveis
fazere : fazer
fiabiliade : fiabilidade
fianciamento : financiamento
fidalgias : fidalguias
flutuaações : flutuações
fomato : formato
frustados : frustrados
gabinte : gabinete
garatir : garantir
graande : grande
Homesns : Homens
idea : ideia
ideiua : ideia
imeditamente : imediatamente
implemenetam : implementam
impossival : impossível
imputads : imputados
inauguardo : inaugurado
inciar : iniciar
inciativas : iniciativas
incrito : inscrito
Indistrial : Industrial
indiviseis : indivisíveis
indivuduais : individuais
infomações : informações
inforamção : informação
informmatica : informática
inscever-se : inscrever-se
instituoção : instituição
institutoas : institutos
interesado : interessado
interesados : interessados
interesante : interessante
interssado : interessado
Intituições : Instituições
investigção : investigação
iscussão : discussão
isoladamnete : isoladamente
itesm : itens
laçamento : lançamento
leventado : levantado
liagassem : ligassem
liberação : libertação
licancas : licenças
licenciatua : licenciatura
LUMIMOSA : LUMINOSA
malata : malta
mandase : mandasse
mandassess : mandasses
mebros : membros
memso : mesmo
mewses : meses
momemto : momento
Multmedia : Multimédia
mundança : mudança
muuito : muito
nào : não
naao : não
nais : mais
natale : natal
necesitar : necessitar
necessáio : necessário
nemhuma : nenhuma
nomeadamentem : nomeadamente
nomeadamento : nomeadamente
nomedamente : nomeadamente
numca : nunca
nuneros : números
oferecen : oferecem
optimisitico : optimístico
organigrams : organigramas
orginador : originador
ortigráfica : ortográfica
ortigráfico : ortográfico
ourtra : outra
panhado : apanhado
partípio : particípio
partica : pratica
partilihar : partilhar
pekla : pela
perceisamente : precisamente
perguntaou : perguntou
persectivas : perspectivas
pesssoa : pessoa
pesssoal : pessoal
podera : poderá
podiamo : podíamos
podria : poderia
porgrama : programa
poss-te : posso-te
posssível : possível
possso : posso
postall : postal
pprimeiras : primeiras
prblemas : problemas
preceso : preciso
previsvel : previsível
princio : princípio
probelma : problema
procedimeto : procedimento
processamneto : processamento
produtivade : produtividade
profisssional : profissional
prograssos : progressos
prolemas : problemas
proposcoes : proporções
publicaçaões : publicações
Qando : Quando
qaulidade : qualidade
quarquer : qualquer
qui : aqui
qunto : quanto
qye : que
recional : racional
recuros : recursos
relacinado : relacionado
relaizar : realizar
repetui-se : repetiu-se
reponsáveis : responsáveis
reponsavel : responsável
respectvos : respectivos
responsabnilidade : responsabilidade
sacricios : acrifícios
Segeum-se : Seguem-se
segir : eguir
seguines : eguintes
selaecção : elecção
senytido : entido
serai : erei
Seviço : Serviço
seviços : erviços
sguerras : guerras
Sgundo : Segundo
sintactica : intáctica
situção : ituação
sugestõoes : ugestões
taçcas : taças
taduções : traduções
tecnogia : tecnologia
telvez : talvez
temnho : tenho
testest : testes
tiveese : tivesse
tranporte : transporte
trentem : tentem
úultima : última
uiniversitarios : universitários
Unversidadese : Universidades
uperiores : uperiores
Utilizdores : Utilizadores
vançar : avançar
verique : verifique
versào : versão
versãO : versãO
vwerificar : verificar
wais : vais
experiancia : experiência
á : à
abóboda : abóbada
absti-me : abstive-me
abstrato : abstracto
aceço : acesso
acelarar : acelerar
àcerca : acerca
acerção : asserção
acessabilidade : acessibilidade
aceza : acesa
acezo : aceso
acordãos : acórdãos
açoreano : açoriano
açossiar : associar
actris : actriz
adamastor : Adamastor
adeuzinho : adeusinho
Adotamos : Adoptamos
adotar : adoptar
adquirí-los : adquiri-los
aério : aéreo
aero-clube : aeroclube
ageitar : ajeitar
agonisar : agonizar
agradaveis : agradáveis
ajuisar : ajuizar
album : álbum
albuns : álbuns
alerjia : alergia
alfasema : alfazema
alforje : alforge
algasarra : algazarra
algerós : algeroz
algoses : algozes
alissiante : aliciante
alissiar : aliciar
alizar : alisar
alumeia : alumia
àmanhã : amanhã
âmbigua : ambígua
âmbiguidade : ambiguidade
amenisar : amenizar
analizador : analisador
analizar : analisar
análize : análise
ância : ânsia
ansestral : ancestral
ansestralidade : ancestralidade
ansiolitico : ansiolítico
ansiulítico : ansiolítico
antigùidade : antiguidade
aporado : apurado
aporar : apurar
aporteguesamento : aportuguesamento
aporteguesar : aportuguesar
aquem : aquém
àquem : aquém
aquí : aqui
arborisar : arborizar
aridês : aridez
armazem : armazém
armazens : armazéns
arquiteto : arquitecto
Arquitetura : Arquitectura
arrange : arranje
arrangei : arranjei
arrangemos : arranjemos
arranges : arranjes
arrazado : arrasado
arrazar : arrasar
arrea : arreia
arregassado : arregaçado
arregassar : arregaçar
artfício : artifício
asáfama : azáfama
ascenção : ascensão
aseite : azeite
asenha : azenha
asia : azia
asimute : azímute
assás : assaz
asseço : acesso
assersão : asserção
assesso : acesso
Assessoria : Acessoria
assossiar : associar
assúcar : açúcar
assucena : açucena
atabalhuar : atabalhoar
atarrachar : atarraxar
aterrorisar : aterrorizar
atléctico : atlético
atraiçôe : atraiçoe
atraissoar : atraiçoar
atraiste : atraíste
atraves : através
atravez : através
atraz : atrás
atrazar : atrasar
atrazo : atraso
atribuia : atribuía
atribuiam : atribuíam
atribuiamos : atribuíamos
atribuimos : atribuímos
atribuiram : atribuíram
atribuírei : atribuirei
atribuirem : atribuírem
atribuíremos : atribuiremos
atribuitivo : atributivo
atriz : actriz
atual : actual
audio-visual : audiovisual
Autoestradas : Auto-estradas
automatisação : automatização
autorisar : autorizar
autosuspensão : auto-suspensão
autosuspenso : auto-suspenso
autosustentação : auto-sustentação
averigue : averigúe
avizado : avisado
avizar : avisar
avizo : aviso
azíago : aziago
azuleijo : azulejo
azuleijos : azulejos
babozeira : baboseira
babuseira : baboseira
bacharlato : bacharelato
bactriana : bacteriana
badagaio : vadagaio
balisa : baliza
banderilha : bandarilha
baptisar : baptizar
baqueteriano : bacteriano
barcassa : barcaça
barróco : barroco
barrócos : barrocos
basar : bazar
basófia : bazófia
batizar : baptizar
baze : base
bébe : bebé
bébé : bebé
belesa : beleza
bemequer : bem-me-quer
Bemfica : Benfica
benção : bênção
benificiações : beneficiações
benificiar : beneficiar
benquerer : bem-querer
benvindo : bem-vindo
berbulha : borbulha
bisarro : bizarro
bisexto : bissexto
bisexual : bissexual
bisexualidade : bissexualidade
bissectris : bissectriz
bissessual : bissexual
bissetriz : bissectriz
bocage : Bocage
boia : bóia
boiam : bóiam
boie : bóie
boiem : bóiem
boio : bóio
bolir : bulir
bonus : bónus
borbolha : borbulha
borbolhar : borbulhar
braza : brasa
brazil : Brasil
bregeiro : brejeiro
briza : brisa
bruxelas : Bruxelas
bujiar : bugiar
burborinho : burburinho
busina : buzina
cafeina : cafeína
cafeseiro : cafezeiro
caichilho : caixilho
caiem : caem
caimbras : cãibras
caímbras : cãibras
caíndo : caindo
caír : cair
caír-lhe : cair-lhe
caira : caíra
caírá : cairá
cairam : caíram
caírão : cairão
caírás : cairás
caírdes : cairdes
cairem : caírem
caíremos : cairemos
caires : caíres
cairmos : caírmos
caírmos : cairmos
calcáreo : calcário
cális : cálice
calsar : calçar
calvice : calvície
campaínha : campainha
campião : campeão
cançar : cansar
cançaso : cansaço
cançasso : cansaço
cansão : canção
cãosinho : cãozinho
cãozínho : cãozinho
capás : capaz
captivo : cativo
carácteres : caracteres
carangueijo : caranguejo
carateres : caracteres
carcassa : carcaça
cardio-vascular : cardiovascular
Carissimos : Caríssimos
carlos : Carlos
carmos : Carmos
carrocel : carrossel
carroucel : carrossel
cartomância : cartomancia
cascável : cascavel
cassarola : caçarola
catalizar : catalisar
catálize : catálise
catura : captura
causadíaco : causídico
cêra : cera
cérca : cerca
cêrca : cerca
cerimônia : cerimónia
cerralheiro : erralheiro
certâme : certame
certesa : certeza
cetásseo : cetáceo
ceu : céu
cezariana : cesariana
chaile : xaile
chale : xale
chapeu : chapéu
chasso : chaço
chatiar : chatear
chatiava : chateava
chatisse : chatice
cheché : xexé
chéché : xexé
cheinho : cheiinho
cheínho : cheiinho
cheíssimo : cheiíssimo
chícara : xícara
chuxa : chucha
cicatrisar : cicatrizar
cicratisar : cicatrizar
cintaxe : intaxe
ciume : ciúme
claresa : clareza
classismo : classicismo
cobissa : cobiça
coca-cola : Coca-cola
côdia : côdea
colectivisação : colectivização
coletivização : colectivização
colijir : coligir
colinária : culinária
colizeu : coliseu
combóio : comboio
comperativa : cooperativa
complementariedade : complementaridade
compreenção : compreensão
comprendeu : compreendeu
compurscar : conspurcar
comumente : comummente
concenso : consenso
concluia : concluía
concluira : concluíra
concluírmos : concluirmos
concluíu : concluiu
condizessem : condissessem
condú-la : condu-la
condus : conduz
condusir : conduzir
conecsão : conexão
conexionados : conexos
côngegue : cônjuge
cônjuga : cônjuge
cônjugue : cônjuge
conscencioso : consciencioso
consciencia : consciência
consegui-se : conseguisse
conserne : concerne
consernir : concernir
consider : considere
consinteis : consintais
consomas : consumas
consomir : consumir
consporcar : conspurcar
Constacto : Constato
constitue : constitui
constituia : constituía
constituíndo : constituindo
constituira : constituíra
constituitivo : constitutivo
constroiem : constroem
construi : construí
construia : construía
contêem : contêm
contens : conténs
conti-me : contive-me
contra-prova : contraprova
contracto : contrato
contractos : contratos
contrai-lo : contraí-lo
contraiem : contraem
contrassenso : contra-senso
contribuínte : contribuinte
contribuitivo : contributivo
contricção : contrição
control : controlo
contrôle : controlo
convem : convém
convens : convéns
convir : convier
cór : cor
côr : cor
corajem : coragem
cordeal : cordial
córes : cores
côres : cores
coroneis : coronéis
corrícolo : currículo
corrículo : currículo
corropio : corrupio
cortezia : cortesia
coscovilheiras : coscuvilheiras
coscovilhice : coscuvilhice
crâneo : crânio
creação : criação
creador : criador
crear : criar
creatura : criatura
creem : crêem
crêm : crêem
creoulo : crioulo
cristamente : cristãmente
cristanmente : cristãmente
crusador : cruzador
crusar : cruzar
cruseiro : cruzeiro
cubiça : cobiça
cubiçar : cobiçar
culidir : colidir
culigir : coligir
culina : colina
culisão : colisão
culiseu : coliseu
currícolo : currículo
curropio : corrupio
custume : costume
da-me : dá-me
damos-nos : damo-nos
dansar : dançar
darnos : dar-nos
decaiem : decaem
defenido : definido
defeza : defesa
degecção : dejecção
degejuar : desjejuar
degejum : desjejum
degladiar : digladiar
deixásse-mos : deixássemos
dejeção : dejecção
dejetos : dejectos
deleciosas : deliciosas
delegenciar : diligenciar
deligencia : diligência
dêm : dêem
deminuto : diminuto
démos : demos
depôr : depor
depos : depôs
depoz : depôs
depremido : deprimido
depremir : deprimir
derruido : derruído
desaçocego : desassossego
desacôrdo : desacordo
desassocego : desassossego
desassossiar : desassociar
descançar : descansar
descanço : descanso
descelar : desselar
descontração : descontracção
descubri : descobri
desenchabido : desenxabido
desenteria : disenteria
desfasajem : desfasagem
desfazagem : desfasagem
desfazer-te-ia : desfar-te-ia
desfeicho : desfecho
desfês : desfez
deshabitar : desabitar
desharmonia : desarmonia
deshonestidade : desonestidade
deshonesto : desonesto
deshonra : desonra
desiquelíbrio : desequilíbrio
desiquilíbrio : desequilíbrio
deslisar : deslizar
deslise : deslize
desmoralisar : desmoralizar
desoito : dezoito
despachanta : despachante
despedí-la : despedi-la
despêndio : dispêndio
despendioso : dispendioso
despeza : despesa
desprézo : desprezo
desprêzo : desprezo
desseminado : disseminado
desseminar : disseminar
desser : descer
dessimulação : dissimulação
dessimulado : dissimulado
dessimular : dissimular
destinta : distinta
destroi : destrói
destruido : destruído
deteu : deteve
dexer : descer
dezacordo : desacordo
dezaçossiar : desassociar
dezalinho : desalinho
dezentendimento : desentendimento
dezespero : desespero
dezóito : dezoito
dí-lo : di-lo
dição : dicção
diccionário : dicionário
dignatário : dignitário
dignitáreo : dignitário
dijerir : digerir
dijestão : digestão
dijiro : digiro
diminuiram : diminuíram
diminuitivo : diminutivo
dinossaurios : dinossáurios
diónisicas : dionisíacas
dirijisse : dirigisse
dis : diz
discreção : discrição
discuções : discussões
diser : dizer
disfruta-se : desfruta-se
disfrutado : desfrutado
disfrutador : desfrutador
disfrutar : desfrutar
disfrute : desfrute
dispar : díspar
dispendedor : despendedor
dispender : despender
dispendido : despendido
disposer : dispuser
dissere : disser
dissereis : disséreis
dissuador : dissuasor
dissuazivo : dissuasivo
dissuazor : dissuasor
distenção : distensão
distrai-lo : distraí-lo
distraiem : distraem
distraír : distrair
distribui-lo : distribuí-lo
districto : distrito
divêrgencia : divergência
dizer-se-á : dir-se-á
dizer-se-ão : dir-se-ão
dizer-te-ia : dir-te-ia
dôo : doo
eboliente : ebuliente
efabolação : efabulação
efabolar : efabular
éfebo : efebo
efeverescência : efervescência
efeverscência : efervescência
egoismo : egoísmo
egurgitar : ingurgitar
egurjitar : ingurgitar
eide : hei-de
electro-encefalograma : electroencefalograma
elejer : eleger
eletrotecnica : electrotécnica
élite : elite
elítico : elíptico
elocidar : elucidar
embaixadora : embaixatriz
embevedar : embebedar
embevedava : embebedava
embriaguês : embriaguez
embucadura : embocadura
embulado : embolado
embular : embolar
embuscada : emboscada
emição : emissão
emiçora : emissora
emitação : imitação
emitar : imitar
emmagrecer : emagrecer
emmoldurar : emoldurar
empreza : empresa
encaiches : encaixos
encaxes : encaixes
encertar : encetar
enchada : enxada
enchado : inchado
enchar : inchar
enchovalhada : enxovalhada
enchovalhar : enxovalhar
enchugar : enxugar
enchuto : enxuto
encómodo : incómodo
encomudo : incómodo
encorage : encoraje
enesqueciveis : inesquecíveis
enesquecivel : inesquecível
ênfa-se : ênfase
engorjitar : engorgitar
engrachador : engraxador
engrachar : engraxar
engurgitar : engorgitar
enluada : aluada
enovador : inovador
entôo : entoo
entráva-mos : entrávamos
entreteste-te : entretiveste-te
entreteu-se : entreteve-se
entreti-me : entretive-me
entretiam : entretinham
entumescer : intumescer
entumescia : intumescia
entupes : entopes
enviezado : enviesado
enxagoar : enxaguar
equisema : eczema
erbanário : ervanário
erbanário : herbanário
ereis : éreis
eremita : ermita
erimita : ermita
eritrocitos : eritrócitos
erodito : erudito
erpes : herpes
érro : erro
êrro : erro
erúdito : erudito
esbóço : esboço
esbôço : esboço
esclamar : exclamar
esclamou : exclamou
esclusivo : exclusivo
esdrúxola : esdrúxula
esfero-gráfica : esferográfica
esforsam : esforçam
esgaseado : esgazeado
esímio : exímio
esmaltear : esmaltar
espaguete : esparguete
especime : espécime
especimens : espécimes
espectativas : expectativas
espertesa : esperteza
espêsso : espesso
espetativa : expectativa
espicassar : espicaçar
espontaniedade : espontaneidade
espontânio : espontâneo
espontânio : espontâneo
espôsa : esposa
espôso : esposo
espurgar : expurgar
esquesitisse : esquisitice
esquesito : esquisito
establecer : estabelecer
estenuante : extenuante
estepor : estupor
esteporado : estuporado
estipidês : estupidez
estómago : estômago
estorsão : extorsão
estórvo : estorvo
estôrvo : estorvo
estranhesa : estranheza
estranjeirismo : estrangeirismo
estranjeiro : estrangeiro
estratejista : estrategista
estravagâncias : extravagâncias
estravasar : extravasar
estraviar : extraviar
estreitesa : estreiteza
estrelato : estrelado
estrépido : estrépito
estrovar : estorvar
estructurado : estruturado
estupurado : estuporado
esvasiar : esvaziar
etério : etéreo
eutanázia : eutanásia
evitae : evitai
excepsão : excepção
exceto : excepto
exdrúxula : esdrúxula
exdrúxulas : esdrúxulas
eximio : exímio
exitar : hesitar
exito : hesito
expecialmente : especialmente
expesso : espesso
explêndido : esplêndido
explendor : esplendor
expontâneo : espontâneo
Extender : Estender
extendidos : estendidas
extorção : extorsão
extravazar : extravasar
fabolar : fabular
faboloso : fabuloso
fac-simile : fac-símile
fachina : faxina
faisca : faísca
faíscar : faiscar
falariam-nos : falar-nos-iam
falásteis : falastes
farça : farsa
faría-mos : faríamos
farramenta : ferramenta
faser : fazer
fazê-lo-ias : fá-lo-ias
fazer-se-á : far-se-á
fazer-se-ão : far-se-ão
femenilidade : feminilidade
fêmur : fémur
femural : femoral
ferrúgem : ferrugem
ferrujem : ferrugem
fertilisar : fertilizar
fí-lo : fi-lo
fiabelidade : fiabilidade
fiablidade : fiabilidade
finaflor : fina-flor
fiqueim : fiquem
fiscalisação : fiscalização
fiscalisar : fiscalizar
físicos-químicos : físico-químicos
fisilogia : fisiologia
fiz-lo : fi-lo
fizes-te : fizeste
fluídez : fluidez
flúidez : fluidez
fluidico : fluídico
fluído : fluido
foguête : foguete
fôr : for
fôra : fora
fôrça : força
fôrem : forem
formusura : formosura
fôro : foro
fortivo : furtivo
forum : fórum
foruns : fóruns
fosforecente : fosforescente
fransido : franzido
fransir : franzir
fraquesa : fraqueza
frenezi : frenesi
frenezim : frenesim
freza : fresa
frezadora : fresadora
friza : frisa
frizar : frisar
frizo : friso
frustatório : frustratório
fugire : fugir
furmosura : formosura
furmusura : formosura
furtuito : fortuito
furtunas : fortunas
gabardine : gabardina
galinácio : galináceo
gasela : gazela
gasua : gazua
gazeado : gaseado
geito : jeito
geitosa : jeitosa
gérme : germe
germen : gérmen
gerundio : gerúndio
giboia : jibóia
gibóia : jibóia
gibóia : jibóia
gimnásio : ginásio
giradiscos : gira-discos
gis : giz
gordoroso : gorduroso
gorgeta : gorjeta
goso : gozo
gózo : gozo
gracil : grácil
graínha : grainha
grangear : granjear
gratuíto : gratuito
gravidês : gravidez
gravideses : gravidezes
GRECIA : GRÉCIA
gromete : grumete
grumête : grumete
gurdoroso : gorduroso
habitoo-se : habituou-se
hainda : ainda
helimotor : heliomotor
helioporto : heliporto
hemorregia : hemorragia
heriditariedade : hereditariedade
hervanário : ervanário
hervanário : herbanário
heterogêneo : heterogéneo
heterogénias : heterogéneas
heterogénio : heterogéneo
hexitar : hesitar
hêxito : êxito
hidrogéneo : hidrogénio
hidrogênio : hidrogénio
hieroglifos : hieróglifos
higiéne : higiene
hijiene : higiene
hilariedade : hilaridade
hiper-sensibilidade : hipersensibilidade
hipnotisação : hipnotização
hipnotisado : hipnotizado
hipnotisador : hipnotizador
hipnotisar : hipnotizar
hipnoze : hipnose
hipodromo : hipódromo
hireditário : hereditário
holandêses : holandeses
homo-sexualidade : homossexualidade
homogêneo : homogéneo
homogénio : homogéneo
homogenizar : homogeneizar
horisonte : horizonte
hóstil : hostil
hovesse : houvesse
íam : iam
iamos : íamos
ías : ias
íbero : ibero
idealogia : ideologia
idenpotente : idempotente
identica : idêntica
idoniedade : idoneidade
ieis : íeis
igiene : higiene
ilhoses : ilhós
ilucidar : elucidar
imcompleto : incompleto
imissão : emissão
imperadora : imperatriz
impertigado : empertigado
implozão : implosão
implusão : implosão
impolsionar : impulsionar
impúdico : impudico
impulsiunar : impulsionar
imundice : imundície
inabeis : inábeis
ináudito : inaudito
incerção : inserção
incerir : inserir
incluia : incluía
incluiam : incluíam
incluido : incluído
incluíndo : incluindo
incluiram : incluíram
incluírão : incluirão
incluírdes : incluirdes
incluiría : incluiria
incluíria : incluiria
incluírmos : incluirmos
incluisse : incluísse
incluíu : incluiu
inclusivé : inclusive
inconpleto : incompleto
incorajar : encorajar
incrostar : incrustar
incrostrada : incrustada
indivídua : indivíduo
infraestrutura : infra-estrutura
Infraestrutura : Infra-estrutura
infraestruturas : infra-estruturas
ingecções : injecções
inglêses : ingleses
inglezice : inglesice
inglezisse : inglesice
inhábil : inábil
ínicio : início
injeção : injecção
insersão : inserção
insistencia : insistência
inssondaveis : insondáveis
inssurreição : insurreição
insurreissão : insurreição
inter-comunicador : intercomunicador
inter-institucionais : interinstitucionais
inter-sexual : intersexual
inter-sexualidade : intersexualidade
interésses : interesses
intergeição : interjeição
interropção : interrupção
intersecsual : intersexual
intervia : intervinha
intervido : intervindo
intervisse : interviesse
interviu : interveio
intransijência : intransigência
intransijente : intransigente
intranzijente : intransigente
intrepor : interpor
intrevido : intervindo
intrevisto : entrevisto
intuia : intuía
inxugar : enxugar
inxuto : enxuto
ir-mos : irmos
irrascível : irascível
items : itens
itenerário : itinerário
jiboia : jibóia
joia : jóia
jóvem : jovem
jóvens : jovens
joventude : juventude
juíso : juízo
juizes : juízes
juizo : juízo
junho : Junho
júniores : juniores
juri : júri
Kg : kg
kilo : quilo
kilómetro : quilómetro
Km : km
ladiar : ladear
lage : laje
lagem : lajem
lambusado : lambuzado
lampeão : lampião
lapis : lápis
largato : lagarto
Latinoamericano : Latino-americano
lé-la : lê-la
lesíria : lezíria
letivo : lectivo
leucocitos : leucócitos
levesa : leveza
liçenças : licenças
licensas : licenças
licensiado : licenciado
liche : lixe
ligeiresa : ligeireza
lijeireza : ligeireza
lijeiro : ligeiro
limpesa : limpeza
linguísta : linguista
linguistica : linguística
linxado : linchado
lógicamente : logicamente
logotipo : logótipo
logutipo : logótipo
lúmbago : lumbago
lunbago : lumbago
lúpolo : lúpulo
lusitaneidade : lusitanidade
lusitaniedade : lusitanidade
maçagista : massagista
macissos : maciços
madre-silva : madressilva
magestoso : majestoso
magresa : magreza
mágua : mágoa
mal-casado : malcasado
mal-cheiroso : malcheiroso
mal-contente : malcontente
mal-criado : malcriado
mal-feito : malfeito
mal-me-quer : malmequer
mal-nascido : malnascido
mal-visto : malvisto
malavisado : mal-avisado
malencarado : mal-encarado
malentendidos : mal-entendidos
malidicências : maledicências
mamarraxo : mamarracho
manganês : manganés
mangerico : manjerico
mantem-se : mantém-se
manti-me : mantive-me
Mariza : Marisa
marmórico : marmóreo
marmório : marmóreo
martirisar : martirizar
matris : matriz
mausoleu : mausoléu
mecher : mexer
mecher-lhe : mexer-lhe
médica-cirúrgica : médico-cirúrgica
médicos-cirúrgicos : médico-cirúrgicos
mediocre : medíocre
medium : médium
mediuns : médiuns
memorandu : memorando
menistro : ministro
mensão : menção
mensionar : mencionar
mercieiro : merceeiro
meretíssimo : meritíssimo
mesericórdia : misericórdia
méta : meta
mêta : meta
meteriologia : meteorologia
métro : metro
microinformática : micro-informática
minímo : mínimo
minissaia : mini-saia
miradoro : miradouro
miuda : miúda
miudo : miúdo
mixto : misto
moiem : moem
moínho : moinho
môlhos : molhos
monocórdia : monocórdica
monotunia : monotonia
môo : moo
mormura : murmura
mormurar : murmurar
mostrão : mostram
mostreios : mostrei-os
muí : moí
mulhado : molhado
multim-media : multimédia
municioso : minucioso
munotonia : monotonia
muribundo : moribundo
mussulmano : muçulmano
mustrar : mostrar
neo-latino : neolatino
neuro-psíquico : neuropsíquico
nitrogéneo : nitrogénio
nitrogênio : nitrogénio
nobresa : nobreza
norueste : noroeste
notabilização : notabilidade
nóvel : novel
nuno : Nuno
núvem : nuvem
obceção : obsessão
obcessão : obsessão
obcessivo : obsessivo
obececar : obcecar
obetenho : obtenho
obezidade : obesidade
objéctivo : objectivo
Objetos : Objectos
obrigatoriadade : obrigatoriedade
obsecação : obcecação
obsecado : obcecado
obseção : obsessão
obsecar : obcecar
obsecassão : obcecação
obseletos : obsoletos
obsequia : obsequeia
obsuletos : obsoletos
obzequiar : obsequiar
ôca : oca
ôco : oco
ocurrer : ocorrer
odia : odeia
odie : odeie
odiem : odeiem
ogemose : osmose
olfativo : olfactivo
oliar : olear
ólio : óleo
omiço : omisso
onanimista : unanimista
openião : opinião
ópinar : opinar
opôr : opor
organisação : organização
organisar : organizar
orgãos : órgãos
orígem : origem
ostrassismo : ostracismo
ótimo : óptimo
ourina : urina
ourinar : urinar
ourinol : urinol
outubro : Outubro
ouví-lo : ouvi-lo
oxilações : oscilações
paciênsia : paciência
pagem : pajem
paizagem : paisagem
pandega : pândega
pândigo : pândego
paposseco : papo-seco
para-choques : pára-choques
parachoques : pára-choques
paralização : paralisação
paralizar : paralisar
paraquedas : pára-quedas
pararraios : pára-raios
parteleira : prateleira
parvoice : parvoíce
passeo : passeio
passiar : passear
passiei : passeei
passiemos : passeemos
passiência : paciência
páteo : pátio
patrimônio : património
pchisbeque : pechisbeque
pêcego : pêssego
pêche : peixe
pecoária : pecuária
pedí-la-ei : pedi-la-ei
péga : pega
pêga : pega
pègada : pegada
peiche : peixe
penalisante : penalizante
pendoricalho : penduricalho
penduresa : pendureza
penecilina : penicilina
penincilina : penicilina
pequenês : pequenez
pera : pêra
pêras : peras
perceisamente : precisamente
perceito : preceito
perceptorado : preceptorado
perclaro : preclaro
perconizar : preconizar
percuária : pecuária
pérda : perda
perdominar : predominar
perduar : perdoar
perduou : perdoou
perferivel : preferível
periodo : período
perjuízo : prejuízo
permissa : premissa
perpúcio : prepúcio
persagiam : pressagiam
persentido : pressentido
perspetiva : perspectiva
perstações : prestações
persuazão : persuasão
pertensão : pretensão
perverção : perversão
pesarozo : pesaroso
pescôço : pescoço
pêso : peso
pesso : peço
petisa : petiza
petrólio : petróleo
pêxe : peixe
pezadelo : pesadelo
pezar : pesar
pezaroso : pesaroso
pictoresco : pinturesco
pilôto : piloto
pilótos : pilotos
pintoresco : pinturesco
pique-nique : piquenique
piquena : pequena
pirezinho : piresinho
piroupo : piropo
pituresco : pitoresco
piugada : peugada
platéia : plateia
pleiade : plêiade
po-lo : pô-lo
pobresa : pobreza
pobresinho : pobrezinho
poco : pouco
pôco : pouco
podera : pudera
poderam : puderam
poderia-me : poder-me-ia
podessemos : pudéssemos
poem : põem
pôem : põem
poéticos-literários : poético-literários
polas : pulas
poligâmia : poligamia
politecnico : politécnico
ponteagudo : pontiagudo
porlongar : prolongar
porlongue : prolongue
portecção : protecção
portugues : português
portuguêsa : portuguesa
portuguêsmente : portuguesmente
porvidência : providência
pos : pôs
poseres : puseres
posescolar : pós-escolar
posesses : pusesses
posglaciário : pós-glaciário
posoperatório : pós-operatório
possiblidade : possibilidade
possiveis : possíveis
possivel : possível
potuguezismo : portuguesismo
pôz-se : pôs-se
pozes : poses
pozésseis : pusésseis
pozéssemos : puséssemos
pozinhos : posinhos
prá : prà
precalço : percalço
preceitoar : preceituar
preceverança : perseverança
precizar : precisar
preconisar : preconizar
predidos : perdidos
predumínio : predomínio
prefazer : perfazer
prejuíso : prejuízo
prejuizo : prejuízo
premear : premiar
prémeo : prémio
premissão : permissão
prencípio : princípio
prenhês : prenhez
preplexidade : perplexidade
preplexo : perplexo
prescrutação : perscrutação
prescrutador : perscrutador
prespectiva : perspectiva
pressajiar : pressagiar
presserverar : perseverar
presseverança : perseverança
prestassões : prestações
presuasão : persuasão
pretenção : pretensão
pretencioso : pretensioso
pretesto : pretexto
preversão : perversão
preversidade : perversidade
preverso : perverso
preverter : perverter
previlégio : privilégio
prezumido : presumido
prezunção : presunção
primasia : primazia
príncepe : príncipe
principe : príncipe
priveligiado : privilegiado
probolemas : problemas
procheneta : proxeneta
productos : produtos
profundesa : profundeza
progreção : progressão
projeto : projecto
projetos : projectos
promenor : pormenor
promenores : pormenores
propragação : propagação
propridade : propriedade
prorogação : prorrogação
prorogado : prorrogado
prorogar : prorrogar
prorrugar : prorrogar
prossessador : processador
protextar : protestar
protexto : protesto
prototipo : protótipo
provalvelmente : provavelmente
proventura : porventura
provéssemos : provêssemos
providencià-lo : providenciá-lo
PROVINIENTE : PROVENIENTE
provinientes : provenientes
pruibido : proibido
psico-social : psicossocial
psico-somático : psicossomático
pû-la : pu-la
pú-lo : pu-lo
puderá : poderá
pulido : polido
pulimos : polimos
pulmunar : pulmonar
puresa : pureza
puz : pus
puzemos : pusemos
puzera : pusera
puzeram : puseram
puzeras : puseras
puzeres : puseres
puzermos : pusermos
puzesse : pusesse
puzesses : pusesses
puzeste : puseste
pxisbeque : pechisbeque
quartas-feiras : Quartas-feiras
queiremos : queiramos
quer-o : quere-o
quere : quer
quere-me : quer-me
quere-se : quer-se
querêmo-lo : queremo-lo
quí-lo : qui-lo
quiça : quiçá
quís : quis
quis-lo : qui-lo
quisere : quiser
quisésteis : quisestes
quissá : quiçá
quiz : quis
quizemos : quisemos
quizer : quiser
quizera : quisera
quizeram : quiseram
quizéramos : quiséramos
quizeras : quiseras
quizerdes : quiserdes
quizerem : quiserem
quizeres : quiseres
quizesse : quisesse
quizessem : quisessem
quizeste : quiseste
quizésteis : quisestes
rabuge : rabuje
rabujento : rabugento
rabujice : rabugice
rabuscada : rebuscada
rádio-amador : radioamador
raínha : rainha
raíz : raiz
rangir : ranger
rapasinho : rapazinho
ràpidamente : rapidamente
rasia : razia
raza : rasa
razo : raso
reajir : reagir
recaiem : recaem
recentimento : ressentimento
recentir : ressentir
recepiente : recipiente
rectroactivas : retroactivas
rectroactivo : retroactivo
rectroactivos : retroactivos
redatorial : redactorial
redijir : redigir
redol : Redol
reeinstalar : reinstalar
refelexão : reflexão
refer-se : refere-se
referirnos-emos : referir-nos-emos
refletir : reflectir
regeição : rejeição
regeitar : rejeitar
rêgo : rego
regorgitar : regurgitar
reincarnar : reencarnar
reinvidicações : reivindicações
reinvidicar : reivindicar
rejeissão : rejeição
rejisto : registo
rejovenescer : rejuvenescer
rejovenescimento : rejuvenescimento
relacção : relação
relaccionados : relacionados
remedia : remedeia
remedio : remedeio
repucho : repuxo
repurtório : repertório
requere : requer
requere-se : requer-se
requesitos : requisitos
resgistados : registados
resplandescência : resplandecência
resplandescente : resplandecente
ressaiem : ressaem
ressurjir : ressurgir
ressurreissão : ressurreição
réstea : réstia
restricto : restrito
restrinjir : restringir
reteu : reteve
reto : recto
reunes : reúnes
reúnir : reunir
reuno : reúno
rezina : resina
riagir : reagir
ridícolo : ridículo
ringi : rangi
ringido : rangido
riquesa : riqueza
robéula : rubéola
rolissa : roliça
rolisso : roliço
roptura : ruptura
rouxinois : rouxinóis
roxinol : rouxinol
rúbrica : rubrica
ruí : roí
ruido : ruído
ruimente : ruimmente
sacrilegadamente : acrilegamente
saida : aída
saiem : aem
saimos : aímos
saíndo : aindo
saír : air
saira : aíra
saírá : airá
sairam : aíram
saírão : airão
saírás : airás
saírdes : airdes
sairem : aírem
saíremos : airemos
saires : aíres
saírmos : airmos
saíu : aiu
salganhada : algalhada
saliba : aliva
salvaguadar : alvaguardar
saracotiar : aracotear
sàudade : audade
saude : aúde
sear : cear
secrestar : equestrar
secresto : equestro
secretaría : ecretaria
segnificado : ignificado
seia : ceia
Seleção : Selecção
selecionar : eleccionar
selinidade : enilidade
selvajamente : elvaticamente
selvajem : elvagem
selvajeria : elvageria
semi-anual : emianual
semi-cerrado : emicerrado
semi-circular : emicircular
semi-eixo : emieixo
semi-oficioso : emioficioso
semi-vogal : emivogal
semihomem : emi-homem
semiinconsciente : emi-inconsciente
semirrei : emi-rei
semissábio : emi-sábio
semisselvagem : emi-selvagem
sençura : censura
sensura : censura
sensuras : censuras
sera : cera
sêra : cera
seram : erão
sereal : cereal
seríam : eriam
serimonioso : cerimonioso
serzir : cerzir
setim : cetim
setor : ector
setores : ectores
Sexta-Feira : Sexta-feira
sextas-feiras : Sextas-feiras
siflítico : ifilítico
simbolo : ímbolo
sinosite : inusite
sintasse : intaxe
sintático : intáctico
sintonisar : intonizar
sinuzite : inusite
sôbe : oube
sobrecelente : obresselente
sobrehumano : obre-humano
sobridade : obriedade
socegado : ossegado
socegar : ossegar
socego : ossego
sociadade : ociedade
soçubrar : oçobrar
socumbir : ucumbir
sodeste : udeste
sodueste : udoeste
sòmente : omente
sonâmbolo : onâmbulo
sorjo : urjo
sorrizinho : orrisinho
sorvéte : orvete
sosinho : ozinho
sossobrar : oçobrar
sotãos : ótãos
sovieticos : oviéticos
sòzinho : ozinho
sub-delegado : ubdelegado
sub-grupo : ubgrupo
Sub-grupo : Subgrupo
sub-solos : ubsolos
subesserviência : ubserviência
subibliotecário : ub-bibliotecário
subito : úbito
subrepticiamente : ub-repticiamente
subrepticio : ub-reptício
substituia : ubstituía
substituitivo : ubstitutivo
substituíu : ubstituiu
substracto : ubstrato
suçobrar : oçobrar
sujerir : ugerir
sujestão : ugestão
sunambulismo : onambulismo
súper-homem : uper-homem
superhomem : uper-homem
suprassumo : upra-sumo
supreção : upressão
suprestição : uperstição
supresticioso : upersticioso
surjir : urgir
surprêsa : urpresa
surpreza : urpresa
surrapa : zurrapa
survete : orvete
suspenção : uspensão
susseder : uceder
taboleiro : tabuleiro
talvés : talvez
tambem : também
tartante : tratante
tática : táctica
tático : táctico
teem : têm
tele-guiado : teleguiado
televizivo : televisivo
tém : tem
tem-o : tem-no
tênue : ténue
tênues : ténues
terebentina : terebintina
terjeitos : trejeitos
terramoto : terremoto
terraplanagem : terraplenagem
terraplanar : terraplenar
terraqueo : terráqueo
terráquio : terráqueo
têsteis : têxteis
tetos : tectos
teurapêutico : terapêutico
texteis : têxteis
téxteis : têxteis
tijela : tigela
toráxico : torácico
torcícolo : torcicolo
torsão : torção
torser : torcer
torsida : torcida
torsido : torcido
tôrso : torso
totém : totem
totens : tótemes
toxico : tóxico
tragectória : trajectória
traiem : traem
trajédia : tragédia
trajeto : trajecto
trajetória : trajectória
trájico : trágico
tranquilisador : tranquilizador
tranquilisante : tranquilizante
trânsido : transido
transmetir : transmitir
transmição : transmissão
transmitente : transmissor
tranze : transe
tranzido : transido
traser : trazer
trazê-lo-ei : trá-lo-ei
trazê-lo-ia : trá-lo-ia
trazeira : traseira
trazeiro : traseiro
trazer-nos-ia : trar-nos-ia
trazer-se-á : trar-se-á
trazer-se-ão : trar-se-ão
tregeitos : trejeitos
tres : três
trez : três
tri-campeão : tricampeão
tricampiã : tricampeã
trilingue : trilíngue
tristesa : tristeza
trôco : troco
trousse : trouxe
troussestes : trouxestes
tunel : túnel
turcícolo : torcicolo
ultra-violeta : ultravioleta
úmido : húmido
uníssuno : uníssono
urano : urânio
utilisar : utilizar
utlizadores : utilizadores
vácum : vacum
vagãos : vagões
vasio : vazio
vé : vê
veiculo : veículo
veinculado : veiculado
vém : vem
vérbo : verbo
vêrbo : verbo
veredito : veredicto
veriação : vereação
veriador : vereador
vertígem : vertigem
vertígens : vertigens
veses : vezes
veu : véu
viésteis : viestes
vintem : vintém
vírgem : virgem
visinhança : vizinhança
visinho : vizinho
viuva : viúva
viuvês : viuvez
viúvez : viuvez
viuvo : viúvo
vivaço : vivaz
vivasso : vivaz
vizão : visão
vizar : visar
vizita : visita
vizitante : visitante
vizível : visível
vizualisar : visualizar
vizualizar : visualizar
vocemessê : vossemecê
voô : voou
vôo : voo
voses : vozes
vossemessê : vossemecê
vozeria : vozearia
vuô : voou
vuou : voou
xadresista : xadrezista
xal : xale
xalupa : chalupa
xávena : chávena
xéxé : xexé
xixi : chichi
xucha : chucha
xuxa : chucha
zenite : zénite
zig-zag : ziguezague
á : à
àrvore : árvore
abanbonar : abandonar
acessas : acesas
actividadees : actividades
Administarção : Administração
Agosot : Agosto
algém : alguém
algorimto : algoritmo
amplamante : amplamente
aolgoritmos : algoritmos
aproxiamção : aproximação
arrajemos : arranjemos
avivizinham : avizinham
Barsil : Brasil
Bibliteca : Biblioteca
Bilioteca : Biblioteca
bolachinas : bolachinhas
brincadira : brincadeira
Camarados : Camaradas
candiadatos : candidatos
candiadaturas : candidaturas
candiadturas : candidaturas
caracteriscas : características
cedererem : cederem
Chesfes : Chefes
cinetificas : científicas
cobe : coube
comecâ : começa
computadres : computadores
comtempla : contempla
conguir : conseguir
constitudo : constituído
Contacos : Contactos
contrbuir : contribuir
contrpartida : contrapartida
contunar : continuar
contunar : continuar
correpondencia : correspondência
corres-pondência : correspondência
correspondecia : correspondência
correspondenccia : correspondência
cultuarais : culturais
demaais : demais
demonstarções : demonstrações
desenvimento : desenvolvimento
desenvovimento : desenvolvimento
desulpem : desculpem
dificukdades : dificuldades
diger : dizer
Direccção : Direcção
discusão : discussão
disses : disse
divlugue : divulgue
divugar : divulgar
domnos : donos
doutirado : doutorado
dsenvolvimento : desenvolvimento
eatarem : estarem
econtra : encontra
ecosistemas : ecossistemas
eferendo : referendo
Efificio : Edifício
elegação : delegação
emnos : menos
enconbtra : encontra
ENCONTA-SE : ENCONTRA-SE
ENCONTAM-SE : ENCONTRAM-SE
encontar : encontrar
Epediente : Expediente
escever : escrever
espirrito : espírito
esssa : essa
establecer : estabelecer
estajam : estejam
estass : estas
exeplares : exemplares
existêmcia : existência
exitencia : existência
experiancia : experiência
Extrordinaria : Extraordinária
favoráaveis : favoráveis
fazere : fazer
fiabiliade : fiabilidade
fianciamento : financiamento
fidalgias : fidalguias
flutuaações : flutuações
fomato : formato
frustados : frustrados
gabinte : gabinete
garatir : garantir
graande : grande
Homesns : Homens
idea : ideia
ideiua : ideia
imeditamente : imediatamente
implemenetam : implementam
impossival : impossível
imputads : imputados
inauguardo : inaugurado
inciar : iniciar
inciativas : iniciativas
incrito : inscrito
Indistrial : Industrial
indiviseis : indivisíveis
indivuduais : individuais
infomações : informações
inforamção : informação
informmatica : informática
inscever-se : inscrever-se
instituoção : instituição
institutoas : institutos
interesado : interessado
interesados : interessados
interesante : interessante
interssado : interessado
Intituições : Instituições
investigção : investigação
iscussão : discussão
isoladamnete : isoladamente
itesm : itens
laçamento : lançamento
leventado : levantado
liagassem : ligassem
liberação : libertação
licancas : licenças
licenciatua : licenciatura
LUMIMOSA : LUMINOSA
malata : malta
mandase : mandasse
mandassess : mandasses
mebros : membros
memso : mesmo
mewses : meses
mis'erios  mistérios : t
momemto : momento
Multmedia : Multimédia
mundança : mudança
muuito : muito
nào : não
naao : não
nais : mais
natale : natal
necesitar : necessitar
necessáio : necessário
nemhuma : nenhuma
nomeadamentem : nomeadamente
nomeadamento : nomeadamente
nomedamente : nomeadamente
numca : nunca
nuneros : números
oferecen : oferecem
optimisitico : optimístico
organigrams : organigramas
orginador : originador
ortigráfica : ortográfica
ortigráfico : ortográfico
ourtra : outra
panhado : apanhado
partípio : particípio
partica : pratica
partilihar : partilhar
pekla : pela
perceisamente : precisamente
perguntaou : perguntou
persectivas : perspectivas
pesssoa : pessoa
pesssoal : pessoal
podera : poderá
podiamo : podíamos
podria : poderia
porgrama : programa
poss-te : posso-te
posssível : possível
possso : posso
postall : postal
pprimeiras : primeiras
prblemas : problemas
preceso : preciso
previsvel : previsível
princio : princípio
probelma : problema
procedimeto : procedimento
processamneto : processamento
produtivade : produtividade
profisssional : profissional
prograssos : progressos
prolemas : problemas
proposcoes : proporções
publicaçaões : publicações
Qando : Quando
qaulidade : qualidade
quarquer : qualquer
qui : aqui
qunto : quanto
qye : que
recional : racional
recuros : recursos
relacinado : relacionado
relaizar : realizar
repetui-se : repetiu-se
reponsáveis : responsáveis
reponsavel : responsável
respectvos : respectivos
responsabnilidade : responsabilidade
sacricios : acrifícios
Segeum-se : Seguem-se
segir : seguir
seguines : seguintes
selaecção : selecção
senytido : sentido
serai : serei
Seviço : Serviço
seviços : serviços
sguerras : guerras
Sgundo : Segundo
intactica : sintáctica
itução : situação
sugestõoes : sugestões
taçcas : taças
taduções : traduções
tecnogia : tecnologia
telvez : talvez
temnho : tenho
testest : testes
tiveese : tivesse
tranporte : transporte
trentem : tentem
úultima : última
uiniversitarios : universitários
Unversidadese : Universidades
uperiores : uperiores
Utilizdores : Utilizadores
vançar : avançar
verique : verifique
versào : versão
versãO : versãO
vwerificar : verificar
wais : vais
